一	一ＹＩ一
了	乛亅ＬＥ
是	日一<足下>Ｓ
不	不ＢＵ一
我	手戈ＷＯ
这	文辶ＺＥ
在	<在角>土ＺＩ
人	人ＲＮ丿
有	冃ＹＵ
他	亻也ＴＡ
来	未丷ＬＩ
个	人丨ＧＥ
道	<首上>自辶Ｄ
你	亻小Ｎ
大	大ＤＡ一
到	至刂ＤＯ
着	目ＺＥ
就	<享上>小尢Ｊ
上	<卓上>一ＳＧ
们	亻门ＭＮ
那	<那左>阝ＮＡ
也	也ＹＥ乛
说	讠丷儿Ｓ
么	丿厶ＭＥ
下	下ＸＡ一
出	凵山ＣＵ
然	<然角>丶灬Ｒ
地	土也ＤＩ
中	中ＺＧ丨
看	目ＫＮ
时	日寸ＳＩ
要	覀女ＹＯ
没	氵殳ＭＩ
天	一大ＴＮ
过	寸辶ＧＯ
可	可ＫＥ一
自	自ＺＩ丿
子	子ＺＩ乛
能	厶冃匕Ｎ
还	不辶ＨＩ
之	之ＺＩ丶
以	以ＹＩ乛
去	土厶ＱＵ
好	女子ＨＯ
后	<后上>口ＨＵ
为	<冬下>力ＷＩ
都	者阝ＤＵ
会	人云ＨＩ
里	里ＬＩ丨
心	心ＸＮ丶
得	彳日寸Ｄ
对	又寸ＤＩ
身	身ＳＮ丿
手	手ＳＵ丿
起	走己ＱＩ
小	小ＸＯ丨
想	相心ＸＧ
只	口八ＺＩ
而	丆<而下>ＥＲ
和	禾口ＨＥ
头	头ＴＵ丶
她	女也ＴＡ
无	<干变>乚ＷＵ
力	力ＬＩ乛
面	丆罒二Ｍ
己	己ＪＩ乛
如	女口ＲＵ
现	王见ＸＮ
什	亻十ＳＩ
样	木羊ＹＧ
多	夕夕ＤＯ
已	已ＹＩ乛
知	矢口ＺＩ
些	止匕二Ｘ
经	纟<经角>工Ｊ
声	士<声下>ＳＧ
前	<首上><前下>ＱＮ
神	礻日丨Ｓ
笑	丿大Ｘ
事	丨口<秉中>Ｓ
开	开ＫＩ一
点	占灬ＤＮ
方	方ＦＧ丶
眼	目艮ＹＮ
发	发ＦＡ乛
所	<右框>斤Ｓ
但	亻日一Ｄ
气	气ＱＩ丿
法	氵土厶Ｆ
意	音心ＹＩ
情	忄月Ｑ
两	两ＬＧ一
生	丿ＳＧ
家	宀豕ＪＡ
间	门日ＪＮ
将	丬夕寸Ｊ
很	彳艮ＨＮ
真	十<具上>八Ｚ
话	讠舌ＨＡ
成	戊ＣＧ
让	讠<卓上>一Ｒ
被	衤皮ＢＩ
老	耂匕ＬＯ
动	云力ＤＧ
当	彐ＤＧ
用	用ＹＧ丿
于	于ＹＵ一
见	见ＪＮ丨
回	囗口ＨＩ
又	又ＹＵ乛
军	冖车ＪＮ
把	扌巴ＢＡ
此	止匕ＣＩ
才	才ＣＩ一
几	几ＪＩ丿
战	占戈ＺＮ
正	一止ＺＧ
龙	龙ＬＧ一
明	日月ＭＧ
从	从ＣＧ丿
却	土厶卩Ｑ
长	长ＣＧ丿
十	十ＳＩ一
三	三ＳＮ一
女	女ＮＵ乛
光	一儿Ｇ
再	王冂ＺＩ
向	<向框>口ＸＧ
实	宀头ＳＩ
最	日耳又Ｚ
行	彳亍ＸＧ
高	<高外>口ＧＯ
本	木一ＢＮ
打	扌丁ＤＡ
定	宀一<足下>Ｄ
进	井辶ＪＮ
魔	广林<见下>Ｍ
风	风ＦＧ丿
给	纟亼口Ｊ
问	门口ＷＮ
国	囗王丶Ｇ
色	巴ＳＥ
同	冂一口Ｔ
种	禾中ＺＧ
走	走ＺＵ一
其	其ＱＩ一
年	<年下>ＮＮ
口	口ＫＵ丨
王	王ＷＧ一
怎	乍心ＺＮ
边	力辶ＢＮ
次	冫欠ＣＩ
全	人王ＱＮ
白	白ＢＩ丿
吧	口巴ＢＡ
儿	儿ＥＲ丿
感	戊一心Ｇ
果	日木ＧＯ
听	口斤ＴＧ
啊	口阝可Ａ
体	亻木一Ｔ
外	夕卜ＷＩ
死	歹匕ＳＩ
飞	乙冫ＦＩ
分	八刀ＦＮ
主	主ＺＵ丶
觉	<学上>见ＪＥ
住	亻主ＺＵ
少	少ＳＯ丨
比	比ＢＩ一
空	穴工ＫＧ
因	囗大ＹＮ
门	门ＭＮ丶
等	土寸Ｄ
轻	<车旁><经角>工Ｑ
直	十<具上>ＺＩ
第	弓丿Ｄ
候	亻<候角>矢Ｈ
脸	月亼<应下>Ｌ
相	相ＸＧ一
强	弓口虫Ｑ
何	亻可ＨＥ
张	弓长ＺＧ
快	忄夬ＫＩ
做	亻古攵Ｚ
重	千里ＺＧ
与	与ＹＵ一
太	大丶ＴＩ
应	广<应下>ＹＧ
刚	冂乂刂Ｇ
接	扌立女Ｊ
位	亻立ＷＩ
便	亻一乂Ｂ
量	日一里Ｌ
更	一日乂Ｇ
难	又隹ＮＮ
名	夕口ＭＧ
二	二ＥＲ一
内	内ＮＩ丨
连	车辶ＬＮ
水	水ＳＩ丨
西	西ＸＩ一
黑	黑ＨＩ丨
马	马ＭＡ乛
部	立口阝Ｂ
入	丿丶ＲＵ
作	亻乍ＺＯ
吗	口马ＭＡ
兵	丘八ＢＧ
师	<归左>一巾Ｓ
虽	口虫ＳＩ
别	另刂ＢＥ
击	<举下>凵ＪＩ
放	方攵ＦＧ
完	宀元ＷＮ
四	囗儿ＳＩ
灵	彐火ＬＧ
公	八厶ＧＧ
并	丷开ＢＧ
先	儿ＸＮ
处	夂卜ＣＵ
士	士ＳＩ一
剑	亼<应下>刂Ｊ
算	目廾Ｓ
东	<东上>小ＤＧ
机	木几ＪＩ
微	<微框>几ＷＩ
城	土戊Ｃ
火	火ＨＯ丶
变	<变上>又ＢＮ
叫	口丩ＪＯ
清	氵月Ｑ
带	<带上>冖巾Ｄ
杀	乂朩ＳＡ
斯	其斤ＳＩ
李	木子ＬＩ
队	阝人ＤＩ
云	云ＹＮ一
者	者ＺＥ一
望	亡月王Ｗ
原	厂白小Ｙ
竟	音儿ＪＧ
像	亻象ＸＧ
惊	忄<享上>小Ｊ
呢	口尸匕Ｎ
安	宀女ＡＮ
山	山ＳＮ丨
星	日丿Ｘ
族	<旗角>矢ＺＵ
海	氵母Ｈ
月	月ＹＥ丿
加	加ＪＡ乛
金	金ＪＮ丿
目	目ＭＵ丨
特	牜土寸Ｔ
跟	艮ＧＮ
场	土<乃上><两撇>Ｃ
林	林ＬＮ一
由	由ＹＵ丨
万	丆ＷＮ
美	大ＭＩ
任	亻壬ＲＮ
使	亻丈口Ｓ
日	日ＲＩ丨
立	立ＬＩ丶
命	亼口卩Ｍ
思	田心ＳＩ
关	<首上>大ＧＮ
百	丆日ＢＩ
转	<车旁>二<专下>Ｚ
理	王里ＬＩ
常	口巾Ｃ
血	丿皿ＸＥ
乎	丿丷丨Ｈ
受	<爱上>又ＳＵ
离	文凵冂Ｌ
该	讠亥ＧＩ
界	田人<齐下>Ｊ
远	元辶ＹＮ
平	干丷ＰＧ
阵	阝车ＺＮ
物	牜勹<两撇>Ｗ
冷	冫今丶Ｌ
数	米女攵Ｓ
信	亻言ＸＮ
刻	亥刂ＫＥ
至	至ＺＩ一
突	穴大丶Ｔ
失	失ＳＩ丿
怪	忄又土Ｇ
随	阝辶Ｓ
五	五ＷＵ一
反	又ＦＮ
找	扌戈ＺＯ
似	亻以ＳＩ
许	讠午ＸＵ
般	舟殳ＢＮ
武	一弋止Ｗ
雷	<雨头>田ＬＩ
非	非ＦＩ丨
奇	大可ＱＩ
通	<甬下>辶Ｔ
解	用牛Ｊ
绝	纟巴Ｊ
怕	忄白ＰＡ
精	米月Ｊ
修	亻夂彡Ｘ
暗	日音ＡＮ
满	氵艹两Ｍ
双	又又ＳＧ
度	广廿又Ｄ
且	且ＱＥ丨
红	纟工ＨＧ
半	半ＢＮ丶
世	世ＳＩ一
始	女厶口Ｓ
倒	亻至刂Ｄ
拉	扌立ＬＡ
今	今ＪＮ丿
它	宀匕ＴＡ
落	<艹氵>各ＬＯ
攻	工攵ＧＧ
学	<学上>子ＸＥ
尔	小ＥＲ
传	亻二<专下>Ｃ
音	音ＹＮ丶
指	扌匕日Ｚ
路	各ＬＵ
越	走戈乚Ｙ
表	<衣下>ＢＯ
石	石ＳＩ一
容	穴<谷下>ＲＧ
紧	<临左>又小Ｊ
哥	可可ＧＥ
合	亼口ＨＥ
罗	罒夕ＬＯ
利	禾刂ＬＩ
冲	冫中ＣＧ
步	止<步下>ＢＵ
够	勹口夕Ｇ
影	日小彡Ｙ
姐	女且ＪＥ
伤	亻力Ｓ
若	艹口Ｒ
亲	立朩ＱＮ
功	工力ＧＧ
整	木攵止Ｚ
弟	丷弓丿Ｄ
丝	<乡上><乡上>一Ｓ
息	自心ＸＩ
吃	口乙Ｃ
众	人从ＺＧ
花	艹亻<化右>Ｈ
势	执力ＳＩ
早	日十ＺＯ
哈	口亼口Ｈ
帝	<旁上>巾ＤＩ
流	氵<充上><流角>Ｌ
团	囗才ＴＮ
青	月ＱＧ
根	木艮ＧＮ
极	木及ＪＩ
静	月亅Ｊ
形	开彡ＸＧ
即	<即左>卩ＪＩ
深	氵木Ｓ
周	<周框>土口Ｚ
近	斤辶ＪＮ
千	千ＱＮ丿
消	氵冃Ｘ
结	纟吉ＪＥ
制	牛冂刂Ｚ
干	干ＧＮ一
帮	<丰变>阝巾Ｂ
速	木口辶Ｓ
楚	林乛<足下>Ｃ
性	忄丿Ｘ
备	夂田ＢＩ
系	丿幺小Ｘ
言	言ＹＮ丶
提	扌日<足下>Ｔ
教	耂子攵Ｊ
皇	白王ＨＧ
令	今丶ＬＧ
文	文ＷＮ丶
雪	<雨头>彐ＸＥ
谁	讠隹ＳＩ
终	纟夂<冬下>Ｚ
必	心丿ＢＩ
站	立占ＺＮ
化	亻<化右>ＨＡ
哪	口<那左>阝Ｎ
破	石皮ＰＯ
认	讠人ＲＮ
忙	忄亡ＭＧ
往	彳主ＷＧ
玉	王丶ＹＵ
级	纟及ＪＩ
车	车ＣＥ一
底	广<卬左>七Ｄ
总	丷口心Ｚ
坐	从土ＺＯ
巨	匚<右框>ＪＵ
男	田力ＮＮ
显	日业ＸＮ
克	古儿ＫＥ
各	各ＧＥ丿
新	立朩斤Ｘ
斗	斗ＤＵ丶
仙	亻山ＸＮ
急	彐心Ｊ
切	七刀ＱＥ
阳	阝日ＹＧ
叶	口十ＹＥ
领	今丶页Ｌ
收	丩攵ＳＵ
衣	亠<衣下>ＹＩ
敢	乛耳攵Ｇ
异	巳廾ＹＩ
围	囗二<韦下>Ｗ
达	大辶ＤＡ
象	象ＸＧ丿
件	亻牛ＪＮ
错	钅日Ｃ
服	月卩又Ｆ
慢	忄日又Ｍ
保	亻口木Ｂ
办	力八ＢＮ
活	氵舌ＨＯ
喜	吉<首上>口Ｘ
片	片ＰＮ丿
杨	木<乃上><两撇>Ｙ
兴	<应下>八ＸＧ
刀	刀ＤＯ乛
摇	扌爫缶Ｙ
准	冫隹ＺＮ
夜	亠亻夂Ｙ
拿	亼口手Ｎ
电	日乚ＤＮ
交	亠父ＪＯ
条	夂朩ＴＯ
朝	十十月Ｃ
华	亻<化右>十Ｈ
管	宀<官下>Ｇ
断	米乚斤Ｄ
兽	丷田口Ｓ
决	冫夬ＪＥ
尽	尺<冬下>ＪＮ
苦	艹古ＫＵ
依	亻亠<衣下>Ｙ
易	日勹<两撇>Ｙ
八	八ＢＡ丿
则	贝刂ＺＥ
露	<雨头>各Ｌ
语	讠五口Ｙ
兰	<首上>二ＬＮ
闪	门人ＳＮ
冰	冫水ＢＧ
足	足ＺＵ丨
记	讠己ＪＩ
德	彳十心Ｄ
响	口<向框>口Ｘ
害	宀丰口Ｈ
及	及ＪＩ丿
球	王<求架>丶Ｑ
阿	阝可ＡＡ
计	讠十ＪＩ
顿	七凵页Ｄ
爱	<爱上>又Ａ
告	口ＧＯ
夫	夫ＦＵ一
七	七ＱＩ一
嘴	口匕用Ｚ
器	吅大吅Ｑ
圣	又土ＳＧ
南	<南上><首上>十Ｎ
留	<卬左>刀田Ｌ
元	元ＹＮ一
敌	舌攵ＤＩ
沉	氵冖几Ｃ
请	讠月Ｑ
官	宀<官下>ＧＮ
威	戊一女Ｗ
每	母ＭＩ
况	冫口儿Ｋ
确	石用Ｑ
答	亼口Ｄ
乱	舌乚ＬＮ
陈	阝<东上>小Ｃ
宝	宀王丶Ｂ
视	礻见ＳＩ
护	扌户ＨＵ
格	木各ＧＥ
脑	月文凵Ｎ
兄	口儿ＸＧ
狂	犭王ＫＧ
淡	氵火火Ｄ
识	讠口八Ｓ
题	日<足下>页Ｔ
停	亻<亮上>丁Ｔ
司	一口Ｓ
低	亻<卬左>七Ｄ
雨	雨ＹＵ一
呼	口丿丨Ｈ
久	丶ＪＵ
未	未ＷＩ一
孩	子亥ＨＩ
卫	<节下>一ＷＩ
脚	月土卩Ｊ
除	阝亼朩Ｃ
古	古ＧＵ一
亚	亚ＹＡ一
字	宀子ＺＩ
骑	马大可Ｑ
房	户方ＦＧ
代	代ＤＩ丿
伙	亻火ＨＯ
鬼	白<见下>厶Ｇ
员	口贝ＹＮ
缓	纟爫又Ｈ
复	日夂Ｆ
六	亠八ＬＵ
黄	由八Ｈ
装	丬士<衣下>Ｚ
居	尸古ＪＵ
凌	冫土夂Ｌ
呵	口可ＨＥ
米	米ＭＩ丶
恐	工几心Ｋ
单	丷日十Ｄ
旁	<旁上>方ＰＧ
钱	钅一戈Ｑ
跑	勹巳Ｐ
布	巾ＢＵ
或	戈口一Ｈ
爷	父<节下>ＹＥ
玩	王元ＷＮ
报	扌卩又Ｂ
疑	匕矢<足下>Ｙ
术	木丶ＳＵ
睛	目月Ｊ
隐	阝心Ｙ
欢	又欠ＨＮ
续	纟十头Ｘ
章	音十ＺＧ
差	工ＣＡ
挥	扌冖车Ｈ
父	父ＦＵ丿
句	勹口ＪＵ
待	彳土寸Ｄ
九	九ＪＵ丿
派	氵<辰下>Ｐ
持	扌土寸Ｃ
类	米大ＬＩ
宇	宀于ＹＵ
丽	一冂冂Ｌ
蓝	艹<临左>皿Ｌ
佛	亻弓<齐下>Ｆ
刘	文刂ＬＵ
忽	勹<两撇>心Ｈ
怀	忄不ＨＩ
您	亻心Ｎ
怒	女又心Ｎ
掉	扌<卓上>十Ｄ
招	扌刀口Ｚ
希	乂巾Ｘ
送	<首上>大辶Ｓ
背	<北左>匕冃Ｂ
工	工ＧＧ一
甚	其乚ＳＮ
烈	歹刂灬Ｌ
卡	<卓上>下ＫＡ
细	纟田ＸＩ
掌	口手Ｚ
论	讠人匕Ｌ
密	宀心山Ｍ
运	云辶ＹＮ
退	艮辶ＴＩ
酒	氵酉ＪＵ
求	<求架>丶ＱＵ
猛	犭子皿Ｍ
另	另ＬＧ丨
射	身寸ＳＥ
集	隹木ＪＩ
首	<首上>自ＳＵ
北	<北左>匕ＢＩ
照	日刀灬Ｚ
晚	日<见下>Ｗ
赶	走干ＧＮ
守	宀寸ＳＵ
木	木ＭＵ一
散	冃攵Ｓ
穿	穴一<牙下>Ｃ
联	耳<首上>大Ｌ
铁	钅失ＴＥ
段	<段左>殳ＤＮ
练	纟<东上><拣角>Ｌ
喝	口日勹Ｈ
需	<雨头>丆<而下>Ｘ
支	十又ＺＩ
巴	巴ＢＡ乛
左	工ＺＯ
陆	阝<举下>凵Ｌ
角	用ＪＯ
书	乛<韦下>丶Ｓ
防	阝方ＦＧ
忍	刀丶心Ｒ
莫	莫ＭＯ一
群	<秉中>丿羊Ｑ
民	巳七ＭＮ
客	宀各ＫＥ
线	纟一戈Ｘ
毫	<亮上>毛ＨＯ
肯	止冃ＫＮ
展	尸<辰下>Ｚ
谢	讠身寸Ｘ
亮	<亮上>几ＬＧ
痛	疒<甬下>Ｔ
股	月殳ＧＵ
造	口辶Ｚ
妖	女丿大Ｙ
虎	虍几ＨＵ
秦	禾ＱＮ
紫	止匕小Ｚ
宫	宀口口Ｇ
激	氵白攵Ｊ
赵	走乂ＺＯ
渐	氵<车旁>斤Ｊ
震	<雨头>厂<辰内>Ｚ
注	氵主ＺＵ
禁	林示ＪＮ
吸	口及ＸＩ
取	耳又ＱＵ
梦	林夕ＭＧ
枪	木人Ｑ
程	禾口王Ｃ
叹	口又ＴＮ
江	氵工ＪＧ
简	门日Ｊ
羽	羽ＹＵ乛
友	又ＹＵ
继	纟米乚Ｊ
念	今心ＮＮ
右	口ＹＵ
萧	艹<秉中><肃下>Ｘ
热	执灬ＲＥ
份	亻八刀Ｆ
乐	<卬左>小ＬＥ
压	厂土丶Ｙ
既	<即左>旡ＪＩ
靠	口非Ｋ
香	禾日ＸＧ
恶	亚心ＥＥ
引	弓丨ＹＮ
止	止ＺＩ丨
包	勹巳ＢＯ
追	<阜上>辶ＺＩ
仅	亻又ＪＮ
寒	宀<冓上><冬下>Ｈ
雅	一<牙下>隹Ｙ
争	<秉中>亅Ｚ
愿	厂白心Ｙ
超	走刀口Ｃ
狠	犭艮ＨＮ
厉	厂丆Ｌ
式	弋工ＳＩ
波	氵皮ＢＯ
刺	木冂刂Ｃ
号	口丂ＨＯ
态	大丶心Ｔ
存	<在角>子ＣＮ
游	氵<旗角>子Ｙ
台	厶口ＴＩ
跳	<兆左><兆右>Ｔ
狼	犭丶艮Ｌ
属	尸丿冂Ｓ
妹	女未ＭＩ
炼	火<东上><拣角>Ｌ
灭	一火ＭＥ
英	艹央ＹＧ
醒	酉日Ｘ
举	<应下>八<举下>Ｊ
嘿	口黑ＨＩ
境	土音儿Ｊ
胜	月丿Ｓ
诉	讠斤丶Ｓ
抱	扌勹巳Ｂ
毕	比十ＢＩ
务	夂力ＷＵ
甲	甲ＪＡ丨
齐	文<齐下>ＱＩ
拍	扌白ＰＩ
唐	广<秉中>口Ｔ
君	<秉中>丿口Ｊ
楼	木米女Ｌ
险	阝亼<应下>Ｘ
院	阝宀元Ｙ
建	<秉中><举下>廴Ｊ
观	又见ＧＮ
柔	<矛下>木Ｒ
逃	<兆左><兆右>辶Ｔ
置	罒十<具上>Ｚ
娘	女丶艮Ｎ
担	扌日一Ｄ
殿	尸殳Ｄ
阴	阝月ＹＮ
呆	口木ＤＩ
层	尸云ＣＧ
试	讠弋工Ｓ
约	纟勹丶Ｙ
凡	几丶ＦＮ
眉	<声下>目ＭＩ
弹	弓丷十Ｄ
救	<求架>丶攵Ｊ
银	钅艮ＹＮ
统	纟<充上>儿Ｔ
否	不口ＦＵ
索	十冖小Ｓ
抓	扌爪ＺＡ
府	广亻寸Ｆ
调	讠<周框>土Ｄ
曾	丷<横日>日Ｚ
魂	云白<见下>Ｈ
基	其土ＪＩ
顶	丁页ＤＧ
峰	山夂丰Ｆ
苏	艹力八Ｓ
图	囗夂<冬下>Ｔ
松	木八厶Ｓ
议	讠丶乂Ｙ
料	米斗ＬＯ
顾	厂页Ｇ
严	亚丿ＹＮ
业	业ＹＥ丨
恩	囗大心Ｅ
礼	礻乚ＬＩ
耳	耳ＥＲ一
选	儿辶Ｘ
余	亼朩ＹＵ
败	贝攵ＢＩ
区	匚乂ＱＵ
顺	川页ＳＮ
皮	皮ＰＩ乛
沙	氵少ＳＡ
瞬	目<爱上><舛右>Ｓ
树	木又寸Ｓ
秘	禾心丿Ｍ
商	<商外><谷下>ＳＧ
组	纟且ＺＵ
块	土夬ＫＩ
汉	氵又ＨＮ
充	<充上>儿ＣＧ
贵	<贵上>贝ＧＩ
迷	米辶ＭＩ
混	氵日比Ｈ
纷	纟八刀Ｆ
示	示ＳＩ一
伸	亻日丨Ｓ
娜	女<那左>阝Ｎ
助	且力ＺＵ
呀	口一<牙下>Ｙ
封	圭寸ＦＧ
排	扌非ＰＩ
期	其月ＱＩ
肉	内人ＲＵ
船	舟几口Ｃ
座	广从土Ｚ
义	丶乂ＹＩ
舰	舟见ＪＮ
闻	门耳ＷＮ
升	丿廾ＳＧ
室	宀至ＳＩ
妈	女马ＭＡ
亡	亡ＷＧ丶
付	亻寸ＦＵ
控	扌穴工Ｋ
警	艹攵言Ｊ
负	贝ＦＵ
推	扌隹ＴＩ
扬	扌<乃上><两撇>Ｙ
模	木莫ＭＯ
芒	艹亡ＭＧ
凤	<风上>又ＦＧ
虚	虍业ＸＵ
默	黑大丶Ｍ
土	土ＴＵ一
技	扌十又Ｊ
费	弓<齐下>贝Ｆ
温	氵日皿Ｗ
市	亠巾ＳＩ
麻	广林ＭＡ
初	衤刀ＣＵ
考	耂丂ＫＯ
拥	扌用ＹＧ
究	穴九ＪＵ
握	扌尸至Ｗ
资	冫欠贝Ｚ
普	<首上>业日Ｐ
翻	丿田羽Ｆ
察	宀<祭上>示Ｃ
独	犭虫ＤＵ
幸	土<首上>十Ｘ
舞	夕<舛右>Ｗ
称	禾小Ｃ
玄	玄ＸＮ丶
母	母ＭＵ乛
暴	日氺Ｂ
按	扌宀女Ａ
孙	子小ＳＮ
睡	目千<垂下>Ｓ
改	己攵ＧＩ
换	扌大Ｈ
素	幺小Ｓ
较	<车旁>亠父Ｊ
具	<具上>八ＪＵ
箭	<首上><前下>Ｊ
品	口吅ＰＮ
忘	亡心ＷＧ
状	丬大丶Ｚ
堂	口土Ｔ
副	畐刂ＦＵ
承	乛水三Ｃ
野	里<予下>Ｙ
锋	钅夂丰Ｆ
洞	氵冂一Ｄ
遇	甲冂辶Ｙ
查	木日一Ｃ
洛	氵各ＬＯ
局	尸口Ｊ
赛	宀<冓上>贝Ｓ
划	戈刂ＨＡ
权	木又ＱＮ
藏	艹戊丆Ｃ
味	口未ＷＩ
丹	<周框>亠ＤＮ
故	古攵ＧＵ
钟	钅中ＺＧ
坏	土不ＨＩ
仍	亻乃ＲＧ
宗	宀示ＺＧ
弱	弓冫弓Ｒ
弄	王廾ＮＧ
脱	月丷儿Ｔ
菲	艹非ＦＩ
胸	月勹乂Ｘ
哼	口<享上>亅Ｈ
药	艹纟勹Ｙ
历	厂力ＬＩ
徐	彳亼朩Ｘ
拳	手ＱＮ
爆	火日氺Ｂ
杰	木灬ＪＥ
谈	讠火火Ｔ
须	彡页ＸＵ
坚	<临左>又土Ｊ
奥	<向框>米大Ａ
仿	亻方ＦＧ
据	扌尸古Ｊ
偷	亻亼<前下>Ｔ
施	<旗角>也ＳＩ
产	立丿ＣＮ
营	艹冖口Ｙ
骨	骨ＧＵ丨
晶	日日日Ｊ
透	禾乃辶Ｔ
尊	酋寸ＺＮ
短	矢一<首上>Ｄ
抬	扌厶口Ｔ
政	一止攵Ｚ
烦	火页ＦＮ
河	氵可ＨＥ
牙	一<牙下>ＹＡ
维	纟隹ＷＩ
证	讠一止Ｚ
卷	ＪＮ
幽	山幺幺Ｙ
草	艹日十Ｃ
森	木林ＳＮ
吴	口一大Ｗ
摆	扌罒厶Ｂ
蒙	艹冖<豕下>Ｍ
危	厂Ｗ
毒	母ＤＵ
投	扌殳ＴＵ
熟	<享上>九灬Ｓ
飘	覀示风Ｐ
导	巳寸ＤＯ
朋	月月ＰＧ
质	十贝Ｚ
释	丿米<举下>Ｓ
喊	口戊一Ｈ
胡	古月ＨＵ
参	厶大彡Ｃ
休	亻木ＸＵ
劲	<经角>工力Ｊ
景	日<享上>小Ｊ
挡	扌彐Ｄ
印	<印左>卩ＹＮ
惜	忄日Ｘ
枫	木风ＦＧ
幻	幺ＨＮ
欲	八<谷下>欠Ｙ
摸	扌莫ＭＯ
烟	火囗大Ｙ
致	至攵ＺＩ
州	州ＺＵ丶
冥	冖日八Ｍ
尼	尸匕ＮＩ
抗	扌亠几Ｋ
妙	女少ＭＯ
翼	羽田八Ｙ
秋	禾火ＱＵ
凝	冫<足下>Ｎ
寻	彐寸ＸＮ
盘	舟皿ＰＮ
永	丶<永下>ＹＧ
板	木又Ｂ
智	矢口日Ｚ
哦	口手戈Ｏ
责	贝ＺＥ
尸	尸ＳＩ乛
傲	亻敖ＡＯ
柳	木<卯左>卩Ｌ
御	彳卩Ｙ
临	<临左><半竹><横日>Ｌ
浪	氵丶艮Ｌ
辈	非车ＢＩ
娇	女丿<齐下>Ｊ
恨	忄艮ＨＮ
吓	口下ＸＡ
价	亻人<齐下>Ｊ
硬	石一乂Ｙ
探	扌木Ｔ
际	阝示ＪＩ
横	木八Ｈ
标	木示ＢＯ
纳	纟内ＮＡ
欧	匚乂欠Ｏ
宁	宀丁ＮＧ
墙	土十囗Ｑ
田	田ＴＮ丨
习	习ＸＩ乛
肩	户冃ＪＮ
戏	又戈ＸＩ
奈	大示ＮＩ
设	讠殳ＳＥ
效	亠父攵Ｘ
福	礻畐ＦＵ
袋	代亠<衣下>Ｄ
移	禾夕夕Ｙ
型	开刂土Ｘ
疯	疒风ＦＧ
毛	毛ＭＯ丿
贝	贝ＢＩ丨
冒	<冒上>目ＭＯ
叔	<卓上>小又Ｓ
碎	石亠十Ｓ
轰	车又又Ｈ
扑	扌卜ＰＵ
奋	大田ＦＮ
饭	饣又Ｆ
科	禾斗ＫＥ
惨	忄厶彡Ｃ
咱	口自ＺＮ
治	氵厶口Ｚ
湖	氵古月Ｈ
环	王不ＨＮ
尘	小土ＣＮ
略	田各ＬＥ
躲	身几木Ｄ
免	口<见下>Ｍ
盟	日月皿Ｍ
珠	王朱ＺＵ
迎	<卬左>卩辶Ｙ
凭	亻壬几Ｐ
规	夫见ＧＩ
犹	犭尢丶Ｙ
雄	厶隹Ｘ
距	匚<右框>Ｊ
伯	亻白ＢＯ
借	亻日Ｊ
域	土戈口Ｙ
床	广木ＣＧ
骂	吅马ＭＡ
莉	艹禾刂Ｌ
朱	朱ＺＵ丿
史	口乂ＳＩ
避	尸辛辶Ｂ
聚	耳又乑Ｊ
皱	彐皮Ｚ
秀	禾乃ＸＵ
韩	十十<韦下>Ｈ
挑	扌<兆左><兆右>Ｔ
降	阝夂<舛右>Ｊ
敬	艹口攵Ｊ
源	氵厂小Ｙ
徒	彳走ＴＵ
束	木口ＳＵ
鲜	鱼羊ＸＮ
撞	扌立里Ｚ
岁	山夕ＳＩ
架	加木ＪＡ
嘛	口广林Ｍ
哭	吅大丶Ｋ
袭	龙亠<衣下>Ｘ
惑	戈口心Ｈ
罪	罒非ＺＩ
节	艹<节下>ＪＥ
罢	罒土厶Ｂ
食	食ＳＩ丿
啦	口扌立Ｌ
唯	口隹ＷＩ
买	乛头ＭＩ
训	讠川ＸＮ
腿	月艮辶Ｔ
稍	禾冃Ｓ
校	木亠父Ｘ
艾	艹乂ＡＩ
诺	讠艹口Ｎ
某	廿一木Ｍ
邪	一<牙下>阝Ｘ
鲁	鱼日ＬＵ
姑	女古ＧＵ
阻	阝且ＺＵ
丁	丁ＤＧ一
塔	土艹口Ｔ
闭	门才ＢＩ
迅	乙十辶Ｘ
逸	兔辶ＹＩ
臣	匚丨<右框>Ｃ
残	歹一戈Ｃ
裂	歹刂<衣下>Ｌ
托	扌丿七Ｔ
良	丶艮ＬＧ
泪	氵目ＬＩ
尖	小大ＪＮ
晓	日<尧上>儿Ｘ
伊	亻<秉中>丿Ｙ
洋	氵羊ＹＧ
屋	尸至ＷＵ
尚	冂口Ｓ
颗	日木页Ｋ
鱼	鱼ＹＵ丿
炸	火乍ＺＡ
仇	亻九ＣＵ
讲	讠井ＪＧ
焰	火臼Ｙ
配	酉己ＰＩ
旧	丨日ＪＵ
绿	纟<录上>水Ｌ
假	亻<右框>又Ｊ
圆	囗口贝Ｙ
验	马亼<应下>Ｙ
番	丿米田Ｆ
搞	扌<高外>口Ｇ
迹	亠<赤下>辶Ｊ
荡	<艹氵><乃上><两撇>Ｄ
彩	爫木彡Ｃ
腾	月马Ｔ
恢	忄火Ｈ
腰	月覀女Ｙ
厅	厂丁ＴＧ
牛	牛ＮＵ丿
吼	口子乚Ｈ
占	占ＺＮ丨
颤	亠一页Ｃ
趣	走耳又Ｑ
梅	木母Ｍ
奔	大十廾Ｂ
臂	尸辛冃Ｂ
愣	忄罒方Ｌ
勇	<甬下>力Ｙ
套	大镸ＴＯ
剩	禾<北左>刂Ｓ
志	士心ＺＩ
舒	亼古<予下>Ｓ
端	立山<而下>Ｄ
虑	虍心ＬＵ
医	匚矢ＹＩ
妮	女尸匕Ｎ
炮	火勹巳Ｐ
蛋	乛<足下>虫Ｄ
卖	十乛头Ｍ
闹	门亠巾Ｎ
颜	立丿页Ｙ
归	<归左>彐ＧＩ
圈	囗Ｑ
限	阝艮ＸＮ
浮	氵爫子Ｆ
弃	<充上>廾ＱＩ
适	舌辶ＳＩ
软	<车旁>欠ＲＮ
抵	扌<卬左>七Ｄ
厚	厂日子Ｈ
帅	<归左>巾ＳＩ
尤	尢丶ＹＵ
讶	讠一<牙下>Ｙ
广	广ＧＧ丶
范	<艹氵>ＦＮ
桌	<卓上>日木Ｚ
欣	斤欠ＸＮ
病	疒一内Ｂ
共	八ＧＧ
职	耳口八Ｚ
诸	讠者ＺＵ
镇	钅十八Ｚ
专	二<专下>ＺＮ
值	亻十<具上>Ｚ
偏	亻户冊Ｐ
杂	九朩ＺＡ
增	土丷日Ｚ
豪	<亮上>豕ＨＯ
咬	口亠父Ｙ
触	用虫Ｃ
陷	阝臼Ｘ
雾	<雨头>夂力Ｗ
挺	扌壬廴Ｔ
炎	火火ＹＮ
稳	禾心Ｗ
择	扌又<举下>Ｚ
巧	工丂ＱＯ
胖	月半ＰＧ
附	阝亻寸Ｆ
盯	目丁ＤＧ
碰	石<首上>业Ｐ
纪	纟己ＪＩ
阶	阝人<齐下>Ｊ
谷	八<谷下>ＧＵ
嗯	口囗心Ｎ
岛	<鸟上>山ＤＯ
夏	丆目夂Ｘ
扫	扌彐ＳＯ
潜	氵夫日Ｑ
毁	臼工殳Ｈ
项	工页ＸＧ
旋	<旗角>乛<足下>Ｘ
抢	扌人Ｑ
抽	扌由ＣＵ
优	亻尢丶Ｙ
迪	由辶ＤＩ
涌	氵<甬下>Ｙ
网	冂乂乂Ｗ
祖	礻且ＺＵ
拜	一丰Ｂ
测	氵贝刂Ｃ
伟	亻二<韦下>Ｗ
案	宀女木Ａ
列	歹刂ＬＥ
谓	讠田冃Ｗ
操	扌口木Ｃ
春	日ＣＮ
店	广占ＤＮ
瑞	王山<而下>Ｒ
善	羊<首上>口Ｓ
逼	畐辶ＢＩ
浑	氵冖车Ｈ
输	<车旁>亼<前下>Ｓ
烧	火<尧上>儿Ｓ
瞪	目癶<首上>Ｄ
慕	莫ＭＵ
懂	忄艹里Ｄ
富	宀畐ＦＵ
汗	氵干ＨＮ
侧	亻贝刂Ｃ
赤	土<赤下>ＣＩ
率	亠幺十Ｌ
杯	木不ＢＩ
京	<享上>小ＪＧ
吉	吉ＪＩ一
滚	氵亠<衣下>Ｇ
曼	日罒又Ｍ
浩	氵口Ｈ
获	艹犭大Ｈ
轮	<车旁>人匕Ｌ
损	扌口贝Ｓ
抖	扌斗ＤＵ
累	田幺小Ｌ
讨	讠寸ＴＯ
苍	艹人Ｃ
悄	忄冃Ｑ
养	丶<齐下>Ｙ
塞	宀<冓上>土Ｓ
鸣	口鸟ＭＧ
挂	扌圭ＧＡ
胆	月日一Ｄ
孤	子瓜ＧＵ
傻	亻<囱框>夂Ｓ
陪	阝立口Ｐ
镜	钅音儿Ｊ
凶	乂凵ＸＧ
吐	口土ＴＵ
杜	木土ＤＵ
猜	犭月Ｃ
庞	广龙ＰＧ
幕	莫巾ＭＵ
琳	王林ＬＮ
蛇	虫宀匕Ｓ
拼	扌丷开Ｐ
孔	子乚ＫＧ
盖	皿ＧＩ
材	木才ＣＩ
扎	扌乚ＺＡ
爸	父巴ＢＡ
预	<予下>页Ｙ
晃	日儿Ｈ
闷	门心ＭＮ
姓	女丿Ｘ
莱	艹未丷Ｌ
仔	亻子ＺＩ
吟	口今ＹＮ
遍	户冊辶Ｂ
彻	彳七刀Ｃ
纯	纟七凵Ｃ
伦	亻人匕Ｌ
盗	冫欠皿Ｄ
愤	忄十贝Ｆ
困	囗木ＫＮ
缘	纟彑<豕下>Ｙ
纵	纟从ＺＧ
啸	口<秉中><肃下>Ｘ
夺	大寸ＤＯ
壁	尸辛土Ｂ
宋	宀木ＳＧ
估	亻古ＧＵ
介	人<齐下>ＪＥ
画	一田凵Ｈ
庄	广土ＺＧ
狗	犭勹口Ｇ
沈	氵<巾变>乚Ｓ
贼	贝戈Ｚ
补	衤卜ＢＵ
摩	广林手Ｍ
脉	月丶<永下>Ｍ
泰	氺ＴＩ
痕	疒艮ＨＮ
燕	廿口灬Ｙ
折	扌斤ＺＥ
劫	土厶力Ｊ
演	氵穴一Ｙ
灰	火ＨＩ
伏	亻大丶Ｆ
悠	亻攵心Ｙ
婆	氵皮女Ｐ
创	人刂Ｃ
研	石开ＹＮ
含	今口ＨＮ
写	冖与ＸＥ
凯	山己几Ｋ
岳	丘山ＹＥ
午	午ＷＵ丿
池	氵也ＣＩ
睁	目亅Ｚ
萨	艹阝丿Ｓ
暂	<车旁>斤日Ｚ
闲	门木ＸＮ
概	木<即左>旡Ｇ
逐	豕辶ＺＵ
旦	日一ＤＮ
登	癶一<首上>Ｄ
误	讠口大Ｗ
戒	戈廾ＪＥ
村	木寸ＣＮ
街	彳圭亍Ｊ
跃	丿大Ｙ
牌	片卑ＰＩ
廷	壬廴ＴＧ
罩	罒<卓上>十Ｚ
斩	<车旁>斤ＺＮ
班	王<班中>王Ｂ
爵	爫<即左>寸Ｊ
陛	阝比土Ｂ
膀	月<旁上>方Ｂ
迟	尺辶ＣＩ
踪	宀示Ｚ
替	夫夫日Ｔ
谋	讠廿木Ｍ
伴	亻半ＢＮ
霸	<雨头>革月Ｂ
傅	亻甫寸Ｆ
怜	忄今丶Ｌ
乌	乌ＷＵ丿
曲	日<临左>ＱＵ
瞧	目隹灬Ｑ
惧	忄<具上>八Ｊ
俊	亻厶夂Ｊ
歌	可可欠Ｇ
咒	吅几ＺＵ
漂	氵覀示Ｐ
嘻	口吉口Ｘ
倍	亻立口Ｂ
采	爫木ＣＩ
昨	日乍ＺＯ
互	一彑ＨＵ
鹰	广亻鸟Ｙ
蒂	艹<旁上>巾Ｄ
舍	亼古ＳＥ
慌	忄艹<流角>Ｈ
糊	米古月Ｈ
犯	犭ＦＮ
扭	扌丑ＮＵ
判	<半变>刂ＰＮ
丢	千一厶Ｄ
羞	丑ＸＵ
昏	<卬左>七日Ｈ
竹	竹ＺＵ丿
唤	口大Ｈ
忧	忄尢丶Ｙ
锐	钅丷儿Ｒ
琴	王王乛Ｑ
宽	宀艹见Ｋ
莲	艹车辶Ｌ
躯	身匚乂Ｑ
郎	丶<即左>阝Ｌ
疼	疒夂<冬下>Ｔ
席	广廿巾Ｘ
伍	亻五ＷＵ
剧	尸古刂Ｊ
碧	王白石Ｂ
征	彳一止Ｚ
鸟	鸟ＮＯ丿
赞	贝Ｚ
丈	丈ＺＧ一
侍	亻土寸Ｓ
悉	丿米心Ｘ
漫	氵日又Ｍ
缩	纟宀日Ｓ
帐	巾长ＺＧ
遭	<曹上>日辶Ｚ
坦	土日一Ｔ
喃	口<南上><首上>Ｎ
悟	忄五口Ｗ
壮	丬士ＺＧ
辰	厂<辰内>ＣＮ
貌	豸白儿Ｍ
鼻	自田丌Ｂ
聊	耳<卯左>卩Ｌ
怨	夕心Ｙ
弓	弓ＧＧ乛
绕	纟<尧上>儿Ｒ
私	禾厶ＳＩ
耀	儿隹Ｙ
财	贝才ＣＩ
掩	扌大乚Ｙ
吞	一大口Ｔ
织	纟口八Ｚ
监	<临左><半竹>皿Ｊ
洗	氵儿Ｘ
佩	亻<风上>一Ｐ
融	一冂虫Ｒ
插	扌千臼Ｃ
梁	氵刀木Ｌ
忠	中心ＺＧ
悲	非心ＢＩ
笔	毛ＢＩ
迫	白辶ＰＯ
凉	冫<享上>小Ｌ
丫	丷丨ＹＡ
鼓	吉<首上>又Ｇ
豫	<予下>象Ｙ
亦	亠<赤下>ＹＩ
敏	母攵Ｍ
狱	犭大丶Ｙ
召	刀口ＺＯ
佣	亻用ＹＧ
忆	忄乙ＹＩ
朵	几木ＤＯ
博	十甫寸Ｂ
狐	犭瓜ＨＵ
吹	口欠ＣＩ
拔	扌犮ＢＡ
荣	艹冖木Ｒ
劳	艹冖力Ｌ
茶	艹人朩Ｃ
缠	纟广里Ｃ
盛	戊皿Ｓ
磨	广林石Ｍ
浓	氵<巾变><辰下>Ｎ
净	冫亅Ｊ
仰	亻<卬左>卩Ｙ
遥	爫缶辶Ｙ
废	广发ＦＩ
恭	八Ｇ
菜	艹爫木Ｃ
阁	门各ＧＥ
缺	缶夬ＱＥ
粗	米且ＣＵ
躺	身冂Ｔ
宣	宀一一Ｘ
桑	又又木Ｓ
绍	纟刀口Ｓ
惯	忄毌贝Ｇ
遗	<贵上>贝辶Ｙ
晕	日冖车Ｙ
执	执ＺＩ一
喷	口十贝Ｐ
刹	乂朩刂Ｓ
努	女又力Ｎ
脆	月Ｃ
轩	<车旁>干ＸＮ
佳	亻圭ＪＡ
耗	耒毛ＨＯ
窗	穴<囱框>夂Ｃ
积	禾口八Ｊ
策	木冂Ｃ
辉	儿车Ｈ
灯	火丁ＤＧ
辛	辛ＸＮ丶
援	扌爫又Ｙ
堆	土隹ＤＩ
扶	扌夫ＦＵ
踏	水日Ｔ
库	广车ＫＵ
屁	尸比ＰＩ
唇	厂<辰内>口Ｃ
奴	女又ＮＵ
翔	羽ＸＧ
熊	厶匕灬Ｘ
粉	米八刀Ｆ
勒	革力ＬＥ
尾	尸毛ＷＩ
批	扌比ＰＩ
乖	千<北左>匕Ｇ
艳	丰巴Ｙ
趁	走人彡Ｃ
慧	丰丰心Ｈ
姬	女匚丨Ｊ
爬	爪巴ＰＡ
隆	阝夂Ｌ
怖	忄巾Ｂ
赏	口贝Ｓ
晨	日厂<辰内>Ｃ
刃	刀丶ＲＮ
媚	女<声下>目Ｍ
耐	丆<而下>寸Ｎ
拖	扌也Ｔ
丰	丰ＦＧ一
码	石马ＭＡ
诚	讠戊Ｃ
律	彳<秉中><举下>Ｌ
乃	乃ＮＩ乛
赫	土<赤下><赤下>Ｈ
曹	<曹上>日ＣＯ
岂	山己ＱＩ
固	囗古ＧＵ
洁	氵吉ＪＥ
盾	十目Ｄ
社	礻土ＳＥ
郭	<享上>子阝Ｇ
骗	马户冊Ｐ
滑	氵骨ＨＡ
霄	<雨头>冃Ｘ
隔	阝一冂Ｇ
纸	纟<卬左>七Ｚ
戴	十戈八Ｄ
额	宀各页Ｅ
惹	艹心Ｒ
撤	扌<充上>攵Ｃ
荒	艹亡<流角>Ｈ
季	禾子ＪＩ
延	丿<延止>廴Ｙ
痴	疒矢口Ｃ
锁	钅贝Ｓ
旗	<旗角>其ＱＩ
撒	扌攵Ｓ
郁	冃阝Ｙ
典	冂八Ｄ
颇	皮页ＰＯ
侯	亻<候角>矢Ｈ
园	囗元ＹＮ
振	扌厂<辰内>Ｚ
仪	亻丶乂Ｙ
省	少目ＳＧ
猎	犭日Ｌ
殊	歹朱ＳＵ
绪	纟者ＸＵ
跪	Ｇ
玛	王马ＭＡ
抚	扌<干变>乚Ｆ
油	氵由ＹＵ
委	禾女ＷＩ
纹	纟文ＷＮ
泉	白水ＱＮ
滴	氵<商外>古Ｄ
洪	氵八Ｈ
启	户口ＱＩ
供	亻八Ｇ
忌	己心ＪＩ
拦	扌<首上>二Ｌ
祭	<祭上>示ＪＩ
妻	十<秉中>女Ｑ
贴	贝占ＴＥ
妇	女彐ＦＵ
庆	广大ＱＧ
擦	扌宀示Ｃ
币	丿巾ＢＩ
婚	女<卬左>日Ｈ
牢	宀牛ＬＯ
仁	亻二ＲＮ
甘	廿一ＧＮ
奶	女乃ＮＩ
径	彳<经角>工Ｊ
倾	亻<比左>页Ｑ
符	亻寸Ｆ
赌	贝者ＤＵ
钻	钅占ＺＮ
蛮	<变上>虫ＭＮ
矮	矢禾女Ａ
唉	口厶矢Ａ
堡	亻口土Ｂ
馆	饣宀<官下>Ｇ
宜	宀且ＹＩ
姿	冫欠女Ｚ
爽	大乂乂Ｓ
堪	土其乚Ｋ
焦	隹灬ＪＯ
劈	尸辛刀Ｐ
零	<雨头>今丶Ｌ
薄	<艹氵>甫寸Ｂ
扰	扌尢丶Ｒ
艘	舟叟ＳＵ
耶	耳阝ＹＥ
牧	牜攵ＭＵ
益	<首上>八皿Ｙ
朗	丶<即左>月Ｌ
挣	扌亅Ｚ
递	丷弓辶Ｄ
匆	勹<两撇>丶Ｃ
肖	冃ＸＯ
婷	女<亮上>丁Ｔ
亏	二<亏下>ＫＩ
袍	衤勹巳Ｐ
燃	火丶灬Ｒ
扯	扌止ＣＥ
叛	<半变>又Ｐ
胁	月力八Ｘ
拒	扌匚<右框>Ｊ
肚	月土ＤＵ
皆	比白ＪＥ
柱	木主ＺＵ
墨	黑土ＭＯ
董	艹千里Ｄ
砸	石匚巾Ｚ
莎	<艹氵>少ＳＡ
液	氵亠夂Ｙ
辆	<车旁>两ＬＧ
途	亼朩辶Ｔ
岩	山石ＹＮ
芳	艹方ＦＧ
慰	尸寸心Ｗ
户	户ＨＵ丶
烂	火<首上>二Ｌ
欺	其欠ＱＩ
针	钅十ＺＮ
砍	石欠ＫＮ
筑	工几Ｚ
醉	酉亠十Ｚ
扔	扌乃ＲＧ
洲	氵州ＺＵ
协	十力八Ｘ
驾	加马ＪＡ
享	<享上>子ＸＧ
漠	氵莫ＭＯ
巫	工从ＷＵ
莹	艹冖王Ｙ
撑	扌手Ｃ
郑	<首上>大阝Ｚ
眨	目丿之Ｚ
赢	<赢框>贝ＹＧ
恼	忄文凵Ｎ
珍	王人彡Ｚ
虫	虫ＣＧ丨
康	广彐水Ｋ
椅	木大可Ｙ
俩	亻两ＬＡ
旅	<旗角>丿<辰下>Ｌ
货	亻<化右>贝Ｈ
减	冫戊一Ｊ
尝	云ＣＧ
盈	乃又皿Ｙ
愧	忄白<见下>Ｋ
邦	<丰变>阝ＢＧ
骇	马亥ＨＩ
餐	<卓上>又食Ｃ
埋	土里ＭＩ
瑟	王心丿Ｓ
抛	扌九力Ｐ
吻	口勹<两撇>Ｗ
敲	<高外><卓上>又Ｑ
猫	犭艹田Ｍ
侵	亻彐又Ｑ
弯	<变上>弓ＷＮ
茫	<艹氵>亡ＭＧ
悔	忄母Ｈ
喘	口山<而下>Ｃ
穴	穴ＸＥ丶
玲	王今丶Ｌ
勾	勹厶ＧＵ
哎	口艹乂Ａ
截	十戈隹Ｊ
舌	舌ＳＥ丿
肃	<秉中><肃下>ＳＵ
牵	大冖牛Ｑ
例	亻歹刂Ｌ
庭	广壬廴Ｔ
彼	彳皮ＢＩ
宙	宀由ＺＵ
氏	<卬左>七ＳＩ
夹	夫丷ＪＡ
霜	<雨头>相ＳＧ
仗	亻丈ＺＧ
济	氵文<齐下>Ｊ
吕	口口ＬＵ
渊	氵<齐下>米Ｙ
卓	<卓上>日十Ｚ
甜	舌廿一Ｔ
笼	龙ＬＧ
柄	木一内Ｂ
嘉	吉<首上>加Ｊ
诡	讠Ｇ
姆	女母ＭＵ
脖	月十子Ｂ
爹	父夕夕Ｄ
霍	<雨头>隹ＨＯ
抹	扌末ＭＯ
艺	艹乙ＹＩ
倩	亻月Ｑ
秒	禾少ＭＯ
昂	日<卬左>卩Ａ
踢	日勹Ｔ
哀	<享上><衣下>ＡＩ
末	末ＭＯ一
奉	<举下>ＦＧ
劝	又力ＱＮ
腹	月夂Ｆ
钢	钅冂乂Ｇ
宏	宀厶Ｈ
爪	爪ＺＡ丿
挤	扌文<齐下>Ｊ
泽	氵又<举下>Ｚ
鸿	氵工鸟Ｈ
核	木亥ＨＥ
侠	亻夫丷Ｘ
猪	犭者ＺＵ
疾	疒矢ＪＩ
瓶	丷开瓦Ｐ
僵	亻一一Ｊ
乘	禾<北左>匕Ｃ
寂	宀小又Ｊ
粮	米丶艮Ｌ
聪	耳丷心Ｃ
诱	讠禾乃Ｙ
懒	忄木贝Ｌ
搭	扌艹口Ｄ
潮	氵十月Ｃ
鹏	月月鸟Ｐ
魏	禾女<见下>Ｗ
咐	口亻寸Ｆ
鸡	又鸟ＪＩ
肤	月夫ＦＵ
薇	艹<微框>几Ｗ
弥	弓小Ｍ
瓦	瓦ＷＡ一
央	央ＹＧ丨
勉	<见下>力Ｍ
川	川ＣＮ丿
屈	尸凵山Ｑ
耸	从耳ＳＧ
匹	匚儿ＰＩ
尺	尺ＣＩ乛
喂	口田<畏下>Ｗ
丧	十<首上><辰下>Ｓ
悍	忄日干Ｈ
悬	且厶心Ｘ
拾	扌亼口Ｓ
晴	日月Ｑ
亿	亻乙ＹＩ
讯	讠乙十Ｘ
溜	氵刀田Ｌ
魄	白白<见下>Ｐ
帕	巾白ＰＡ
括	扌舌ＫＯ
孟	子皿ＭＧ
乔	丿大<齐下>Ｑ
怔	忄一止Ｚ
蕾	艹<雨头>田Ｌ
搜	扌叟ＳＵ
诗	讠土寸Ｓ
偶	亻甲冂Ｏ
均	土勹冫Ｊ
童	立里ＴＧ
覆	覀彳夂Ｆ
厌	厂大丶Ｙ
悦	忄丷儿Ｙ
载	十戈<车旁>Ｚ
掠	扌<享上>小Ｌ
垂	千<垂下>ＣＩ
琪	王其ＱＩ
泄	氵世ＸＥ
霞	<雨头>丨又Ｘ
港	氵巳Ｇ
袁	土口<衣下>Ｙ
臭	自大ＣＵ
衡	彳亍Ｈ
构	木勹厶Ｇ
肌	月几ＪＩ
词	讠一Ｃ
纤	纟千ＸＮ
票	覀示ＰＯ
诀	讠夬ＪＥ
饰	饣巾Ｓ
噬	口工Ｓ
宠	宀龙ＣＧ
脏	月广土Ｚ
袖	衤由ＸＵ
键	钅<秉中>廴Ｊ
穷	穴力ＱＧ
泥	氵尸匕Ｎ
驻	马主ＺＵ
眸	目厶牛Ｍ
航	舟亠几Ｈ
辞	舌辛ＣＩ
乡	<乡上>丿ＸＧ
催	亻山隹Ｃ
宿	宀亻日Ｓ
慎	忄十八Ｓ
魅	白<见下>未Ｍ
撕	扌其斤Ｓ
逆	丷<屮变>辶Ｎ
凑	冫大Ｃ
缝	纟夂辶Ｆ
歉	<首上><兼末>欠Ｑ
授	扌<爱上>又Ｓ
甩	月乚ＳＩ
映	日央ＹＧ
岸	山厂干Ａ
凰	<风上>白王Ｈ
唱	口日日Ｃ
奸	女干ＪＮ
陵	阝土夂Ｌ
崇	山宀示Ｃ
枚	木攵ＭＩ
读	讠十头Ｄ
暖	日爫又Ｎ
扩	扌广ＫＯ
狮	犭一巾Ｓ
瑶	王爫缶Ｙ
沿	氵几口Ｙ
渡	氵广又Ｄ
稀	禾乂巾Ｘ
搂	扌米女Ｌ
恋	<变上>心ＬＮ
捏	扌日土Ｎ
饶	饣<尧上>儿Ｒ
吩	口八刀Ｆ
笨	木一Ｂ
返	又辶Ｆ
赖	木口贝Ｌ
斥	斤丶ＣＩ
贤	<临左>又贝Ｘ
煞	攵灬Ｓ
询	讠勹日Ｘ
斜	亼朩斗Ｘ
撼	扌戊心Ｈ
眯	目米ＭＩ
铺	钅甫ＰＵ
咳	口亥ＫＥ
浅	氵一戈Ｑ
尬	尢人<齐下>Ｇ
尴	尢<临左><半竹>Ｇ
齿	止人凵Ｃ
洒	氵西ＳＡ
督	<卓上>又目Ｄ
奖	丬夕大Ｊ
卑	卑ＢＩ丿
染	氵九木Ｒ
促	亻足ＣＵ
弗	弓<齐下>ＦＵ
娅	女亚ＹＡ
麽	广林厶Ｍ
泛	氵丿之Ｆ
契	丰刀大Ｑ
酷	酉口Ｋ
罚	罒讠刂Ｆ
络	纟各ＬＯ
埃	土厶矢Ａ
课	讠日木Ｋ
屠	尸者ＴＵ
祸	礻口内Ｈ
汇	氵匚ＨＩ
疗	疒乛亅Ｌ
赐	贝日勹Ｃ
刑	开刂ＸＧ
夸	大二<亏下>Ｋ
雕	<周框>土隹Ｄ
检	木亼<应下>Ｊ
祥	礻羊ＸＧ
俗	亻八<谷下>Ｓ
俱	亻<具上>八Ｊ
摔	扌亠十Ｓ
屏	尸丷开Ｐ
麦	夂ＭＩ
闯	门马ＣＧ
予	<予下>ＹＵ
矿	石广ＫＧ
恒	忄一一Ｈ
郡	<秉中>丿阝Ｊ
呜	口乌ＷＵ
疲	疒皮ＰＩ
迈	丆辶Ｍ
寸	寸ＣＮ一
详	讠羊ＸＧ
亭	<亮上>丁ＴＧ
巡	巛辶ＸＮ
滋	氵<首上>幺Ｚ
葛	艹勹乚Ｇ
婴	贝贝女Ｙ
录	<录上>水ＬＵ
涛	氵<丰变>寸Ｔ
冠	冖元寸Ｇ
枝	木十又Ｚ
翅	十又羽Ｃ
窜	穴中ＣＮ
昆	日比ＫＮ
婉	女宀Ｗ
妃	女己ＦＩ
矛	<矛下>ＭＯ
蝶	虫世木Ｄ
瘦	疒叟ＳＵ
编	纟户冊Ｂ
俏	亻冃Ｑ
贪	今贝ＴＮ
繁	攵小Ｆ
绵	纟白巾Ｍ
棋	木其ＱＩ
斧	父斤ＦＵ
裹	亠日<衣下>Ｇ
姜	女ＪＧ
氛	气八刀Ｆ
後	彳幺夂Ｈ
乾	十十乙Ｑ
拨	扌发ＢＯ
慈	<首上>幺心Ｃ
瞒	目艹两Ｍ
嫣	女一<亏下>Ｙ
咕	口古ＧＵ
屑	尸冃Ｘ
铃	钅今丶Ｌ
辱	厂<辰内>寸Ｒ
雀	小隹ＱＥ
冯	冫马ＦＧ
允	厶儿ＹＮ
樱	木贝女Ｙ
愈	亼<前下>心Ｙ
宾	穴丘ＢＮ
晰	日木斤Ｘ
掏	扌勹缶Ｔ
措	扌日Ｃ
啪	口扌白Ｐ
誓	扌斤言Ｓ
农	<巾变><辰下>ＮＧ
糟	米<曹上>日Ｚ
驶	马口乂Ｓ
捉	扌足ＺＯ
祝	礻口儿Ｚ
朕	月<首上>大Ｚ
咯	口各ＫＡ
扮	扌八刀Ｂ
淫	氵爫壬Ｙ
鼠	臼<鼠下>ＳＵ
畏	田<畏下>ＷＩ
羊	羊ＹＧ丶
驱	马匚乂Ｑ
恰	忄亼口Ｑ
璃	王文冂Ｌ
芙	艹夫ＦＵ
烁	火<卬左>小Ｓ
岚	山风ＬＮ
梯	木丷弓Ｔ
裁	十戈<衣下>Ｃ
韵	音勹冫Ｙ
咽	口囗大Ｙ
辕	<车旁>土<衣下>Ｙ
夕	夕ＸＩ丿
涯	氵厂圭Ｙ
卢	<卓上>尸ＬＵ
碍	石日寸Ａ
幅	巾畐ＦＵ
扇	户羽ＳＮ
愕	忄吅<亏下>Ｅ
芸	艹云ＹＮ
哇	口圭ＷＡ
润	氵门王Ｒ
崩	山月月Ｂ
县	且厶ＸＮ
杖	木丈ＺＧ
汤	氵<乃上><两撇>Ｔ
翠	羽亠十Ｃ
健	亻<秉中>廴Ｊ
箱	相ＸＧ
恍	忄儿Ｈ
骷	骨古ＫＵ
捕	扌甫ＢＵ
育	<充上>冃ＹＵ
猴	犭<候角>矢Ｈ
遮	广廿辶Ｚ
泡	氵勹巳Ｐ
麟	<鹿上>米<舛右>Ｌ
扣	扌口ＫＵ
鼎	目<鼎左><鼎右>Ｄ
溃	氵<贵上>贝Ｋ
娃	女圭ＷＡ
髅	骨米女Ｌ
逍	冃辶Ｘ
述	木丶辶Ｓ
豹	豸勹丶Ｂ
评	讠干丷Ｐ
献	<南上><首上>丶Ｘ
涂	氵亼朩Ｔ
序	广<予下>Ｘ
铜	钅冂一Ｔ
饮	饣欠ＹＮ
灾	宀火ＺＩ
湿	氵日业Ｓ
冬	夂<冬下>ＤＧ
贫	八刀贝Ｐ
汹	氵乂凵Ｘ
党	口儿Ｄ
棒	木<举下>Ｂ
贯	毌贝ＧＮ
串	中口ＣＮ
丛	从一ＣＧ
昌	日日ＣＧ
棍	木日比Ｇ
嫁	女宀豕Ｊ
弘	弓厶ＨＧ
肥	月巴ＦＩ
穆	禾白彡Ｍ
挖	扌穴乙Ｗ
阔	门氵舌Ｋ
跌	失ＤＥ
丑	丑ＣＵ乛
赚	贝<首上><兼末>Ｚ
披	扌皮ＰＩ
漆	氵木氺Ｑ
奏	一大Ｚ
贺	加贝ＨＥ
喉	口<候角>矢Ｈ
酸	酉厶夂Ｓ
捷	扌一<足下>Ｊ
卧	匚丨卜Ｗ
凄	冫十女Ｑ
割	宀口刂Ｇ
违	二<韦下>辶Ｗ
役	彳殳ＹＩ
坛	土云ＴＮ
砰	石干丷Ｐ
筋	月力Ｊ
裸	衤日木Ｌ
井	井ＪＧ一
涨	氵弓长Ｚ
沐	氵木ＭＵ
仓	人ＣＧ
巍	山女<见下>Ｗ
宴	宀日女Ｙ
饿	饣手戈Ｅ
鞭	革亻丈Ｂ
馨	士殳日Ｘ
瓜	瓜ＧＡ丿
骚	马又虫Ｓ
匪	匚非ＦＩ
耻	耳止ＣＩ
妄	亡女ＷＧ
肆	镸<秉中><举下>Ｓ
宛	宀夕Ｗ
裤	衤广车Ｋ
蠢	虫虫Ｃ
龟	日乚Ｇ
妥	爫女ＴＯ
霆	<雨头>壬廴Ｔ
雯	<雨头>文ＷＮ
吵	口少ＣＯ
驰	马也ＣＩ
嫩	女木攵Ｎ
审	宀日丨Ｓ
戈	戈ＧＥ一
款	士示欠Ｋ
桥	木丿<齐下>Ｑ
诧	讠宀七Ｃ
晌	日<向框>口Ｓ
勃	十子力Ｂ
搬	扌舟殳Ｂ
仆	亻卜ＰＵ
漏	氵尸雨Ｌ
械	木戈廾Ｘ
彭	吉<首上>彡Ｐ
盔	火皿Ｋ
灌	氵艹隹Ｇ
桃	木<兆左><兆右>Ｔ
黛	代黑ＤＩ
黎	禾勹氺Ｌ
饱	饣勹巳Ｂ
欠	欠ＱＮ丿
抑	扌<卬左>卩Ｙ
疆	弓土一Ｊ
嘶	口其斤Ｓ
辣	<辛变>木口Ｌ
纠	纟丩ＪＵ
签	亼<应下>Ｑ
购	贝勹厶Ｇ
镖	钅覀示Ｂ
揉	扌木Ｒ
愚	甲冂心Ｙ
勤	廿力Ｑ
誉	<应下>八言Ｙ
鄙	口囗阝Ｂ
衫	衤彡ＳＮ
珊	王册ＳＮ
弩	女又弓Ｎ
呈	口王ＣＧ
腕	月宀Ｗ
怡	忄厶口Ｙ
坠	阝人土Ｚ
腥	月日Ｘ
培	土立口Ｐ
牲	牜丿Ｓ
窝	穴口内Ｗ
障	阝音十Ｚ
锦	钅白巾Ｊ
蓉	艹宀<谷下>Ｒ
拢	扌龙ＬＧ
瞳	目立里Ｔ
麒	<鹿上>比其Ｑ
析	木斤ＸＩ
脾	月卑ＰＩ
涩	氵刀止Ｓ
蓦	莫马ＭＯ
铠	钅山己Ｋ
嘲	口十月Ｃ
毅	立<豕下>殳Ｙ
僧	亻丷日Ｓ
尉	尸示寸Ｗ
寺	土寸ＳＩ
链	钅车辶Ｌ
邀	白攵辶Ｙ
企	人止ＱＩ
蜜	宀心虫Ｍ
骤	马又乑Ｚ
趴	八ＰＡ
频	止<步下>页Ｐ
挨	扌厶矢Ａ
蒋	艹丬寸Ｊ
卿	<卯左><即左>卩Ｑ
植	木十<具上>Ｚ
刷	尸巾刂Ｓ
厂	厂ＣＧ一
歪	不一止Ｗ
嚣	吅页吅Ｘ
琼	王<享上>小Ｑ
耍	丆<而下>女Ｓ
龄	止凵丶Ｌ
拟	扌以ＮＩ
崖	山厂圭Ｙ
寨	宀<冓上>朩Ｚ
伐	亻戈ＦＡ
丘	丘ＱＵ丿
柯	木可ＫＥ
磊	石石石Ｌ
晋	亚日ＪＮ
艰	又艮ＪＮ
竞	立口儿Ｊ
碗	石宀Ｗ
慨	忄<即左>旡Ｋ
涉	氵止<步下>Ｓ
艇	舟壬廴Ｔ
谨	讠廿Ｊ
荷	艹亻可Ｈ
跨	大<亏下>Ｋ
浴	氵八<谷下>Ｙ
舱	舟人Ｃ
颠	十八页Ｄ
趟	走冂Ｔ
盒	亼口皿Ｈ
撇	扌丷攵Ｐ
骄	马丿<齐下>Ｊ
逊	子小辶Ｘ
坑	土亠几Ｋ
柜	木匚<右框>Ｇ
摧	扌山隹Ｃ
崔	山隹ＣＩ
幼	幺力ＹＵ
愁	禾火心Ｃ
仑	人匕ＬＮ
姨	女大弓Ｙ
踩	爫木Ｃ
谅	讠<享上>小Ｌ
坤	土日丨Ｋ
绑	纟<丰变>阝Ｂ
锤	钅千<垂下>Ｃ
哑	口亚ＹＡ
贾	覀贝ＪＡ
宰	宀辛ＺＩ
乳	爫子乚Ｒ
陌	阝丆日Ｍ
惠	士日心Ｈ
竖	<临左>又立Ｓ
销	钅冃Ｘ
叮	口丁ＤＧ
访	讠方ＦＧ
虹	虫工ＨＧ
绽	纟宀<足下>Ｚ
沾	氵占ＺＮ
添	氵一Ｔ
沃	氵丿大Ｗ
挽	扌<见下>Ｗ
迦	加辶ＪＡ
舟	舟ＺＵ丿
堵	土者ＤＵ
鹿	<鹿上>比ＬＵ
纱	纟少ＳＡ
巾	巾ＪＮ丨
荆	艹开刂Ｊ
薛	艹<阜上>辛Ｘ
绩	纟贝Ｊ
捂	扌五口Ｗ
枯	木古ＫＵ
腐	广亻内Ｆ
兔	兔ＴＵ丿
凛	冫亠示Ｌ
夷	大弓ＹＩ
梵	林几丶Ｆ
哗	口<化右>十Ｈ
绳	纟口乚Ｓ
靖	立月Ｊ
搏	扌甫寸Ｂ
斌	文一弋Ｂ
颈	<经角>工页Ｇ
筹	<丰变>寸Ｃ
逝	扌斤辶Ｓ
厨	厂一寸Ｃ
辅	<车旁>甫ＦＵ
逗	一口辶Ｄ
藤	艹月氺Ｔ
盼	目八刀Ｐ
咦	口大弓Ｙ
尹	<秉中>丿ＹＮ
呃	口厂Ｅ
芬	艹八刀Ｆ
狸	犭里ＬＩ
矩	矢匚<右框>Ｊ
憾	忄戊心Ｈ
膝	月木氺Ｘ
雁	厂亻隹Ｙ
胳	月各ＧＥ
咧	口歹刂Ｌ
沌	氵七凵Ｄ
於	方人<冬下>Ｙ
墓	莫土ＭＵ
畅	日丨<乃上>Ｃ
擅	扌亠一Ｓ
冻	冫<东上>小Ｄ
摊	扌又隹Ｔ
黯	黑音ＡＮ
泣	氵立ＱＩ
楞	木罒方Ｌ
叉	又丶ＣＡ
籍	耒日Ｊ
牺	牜西ＸＩ
敖	敖ＡＯ一
哄	口八Ｈ
铭	钅夕口Ｍ
霉	<雨头>母Ｍ
躬	身弓ＧＧ
淋	氵林ＬＮ
膊	月甫寸Ｂ
嫌	女<首上><兼末>Ｘ
歇	日乚欠Ｘ
捧	扌<举下>Ｐ
痒	疒羊ＹＧ
塌	土日羽Ｔ
嚷	口亠<衣下>Ｒ
涵	氵乛凵Ｈ
旨	匕日ＺＩ
灿	火山ＣＮ
摄	扌耳又Ｓ
削	冃刂Ｘ
茵	艹囗大Ｙ
嘟	口者阝Ｄ
匕	匕ＢＩ丿
膛	月土Ｔ
拱	扌八Ｇ
肢	月十又Ｚ
眠	目巳七Ｍ
珑	王龙ＬＧ
伪	亻<冬下>力Ｗ
斤	斤ＪＮ丿
逛	犭王辶Ｇ
惶	忄白王Ｈ
励	厂丆力Ｌ
儒	亻<雨头><而下>Ｒ
陡	阝走ＤＵ
仲	亻中ＺＧ
瞄	目艹田Ｍ
哨	口冃Ｓ
羡	冫欠Ｘ
掀	扌斤欠Ｘ
辽	乛亅辶Ｌ
沟	氵勹厶Ｇ
墅	里土Ｓ
汽	氵气ＱＩ
档	木彐Ｄ
隶	彐水ＬＩ
描	扌艹田Ｍ
俘	亻爫子Ｆ
蜂	虫夂丰Ｆ
呐	口内ＮＡ
哲	扌斤口Ｚ
卒	亠从十Ｚ
赔	贝立口Ｐ
裙	衤<秉中>口Ｑ
哮	口耂子Ｘ
寿	<丰变>寸ＳＵ
攀	木木手Ｐ
杆	木干ＧＮ
旺	日王ＷＧ
寇	宀元<卓上>Ｋ
吾	五口ＷＵ
篮	<临左>皿Ｌ
狄	犭火ＤＩ
储	亻讠者Ｃ
鉴	<临左><半竹>金Ｊ
嘀	口<商外>古Ｄ
虏	虍力ＬＵ
嚎	口<亮上>豕Ｈ
赋	贝一弋Ｆ
隙	阝小小Ｘ
炉	火户ＬＵ
呻	口日丨Ｓ
殷	彐殳Ｙ
污	氵二<亏下>Ｗ
辩	<辛变>讠辛Ｂ
篇	户冊Ｐ
嗓	口又木Ｓ
吊	口巾ＤＯ
播	扌丿田Ｂ
颊	夫丷页Ｊ
偿	亻云Ｃ
冤	冖兔ＹＮ
耿	耳火ＧＧ
俯	亻广寸Ｆ
俄	亻手戈Ｅ
躁	口木Ｚ
狞	犭宀丁Ｎ
嗔	口十八Ｃ
廖	广羽彡Ｌ
罕	干ＨＮ
狡	犭亠父Ｊ
溅	氵贝戈Ｊ
蹲	酋寸Ｄ
焕	火大Ｈ
缕	纟米女Ｌ
嘎	口丆戈Ｇ
烤	火耂丂Ｋ
渴	氵日勹Ｋ
篷	夂辶Ｐ
乏	丿之ＦＡ
擒	扌人冂Ｑ
棠	口木Ｔ
粒	米立ＬＩ
祺	礻其ＱＩ
惩	彳一心Ｃ
患	口口心Ｈ
谦	讠<首上><兼末>Ｑ
汪	氵王ＷＧ
押	扌甲ＹＡ
辨	<辛变><班中>辛Ｂ
蛛	虫朱ＺＵ
歹	歹ＤＩ一
蕴	艹纟皿Ｙ
沸	氵弓<齐下>Ｆ
遣	<贵上><官下>辶Ｑ
陶	阝勹缶Ｔ
迁	千辶ＱＮ
版	片又Ｂ
咆	口勹巳Ｐ
彷	彳方ＰＧ
囊	十口<衣下>Ｎ
劣	少力ＬＥ
芝	艹之ＺＩ
潇	氵艹<肃下>Ｘ
鳞	鱼米<舛右>Ｌ
甫	甫ＦＵ一
逢	夂丰辶Ｆ
玫	王攵ＭＩ
狈	犭贝ＢＩ
邓	又阝ＤＧ
侦	亻<卓上>贝Ｚ
炽	火口八Ｃ
竭	立日勹Ｊ
讽	讠风ＦＧ
挠	扌<尧上>儿Ｎ
拓	扌石ＴＯ
戮	羽彡戈Ｌ
订	讠丁ＤＧ
苟	艹勹口Ｇ
娶	耳又女Ｑ
蔡	艹<祭上>示Ｃ
丸	九丶ＷＮ
佐	亻工Ｚ
宅	宀丿七Ｚ
厢	厂相ＸＧ
驳	马乂乂Ｂ
拐	扌另ＧＩ
昭	日刀口Ｚ
弦	弓玄ＸＮ
淑	氵<卓上>又Ｓ
叠	又又且Ｄ
俞	亼<前下>ＹＵ
辜	古辛ＧＵ
兼	<首上><秉中><兼末>Ｊ
吱	口十又Ｚ
腻	月弋二Ｎ
础	石凵山Ｃ
兮	八丂ＸＩ
琉	王<充上><流角>Ｌ
蓬	艹夂辶Ｐ
厮	厂其斤Ｓ
坡	土皮ＰＯ
咪	口米ＭＩ
朴	木卜ＰＵ
妍	女开ＹＮ
胎	月厶口Ｔ
刮	舌刂ＧＡ
苗	艹田ＭＯ
廊	广丶阝Ｌ
遵	酋寸辶Ｚ
蜀	罒勹虫Ｓ
倭	亻禾女Ｗ
浸	氵彐又Ｊ
滞	氵<带上>巾Ｚ
梭	木厶夂Ｓ
湾	氵<变上>弓Ｗ
韦	二<韦下>ＷＩ
玻	王皮ＢＯ
禀	亠囗示Ｂ
茹	艹女口Ｒ
敛	亼<应下>攵Ｌ
澜	氵门木Ｌ
聂	耳又又Ｎ
疏	乛止<流角>Ｓ
瞎	目宀口Ｘ
豆	一口<首上>Ｄ
溢	氵<首上>皿Ｙ
犬	大丶ＱＮ
廉	广<首上><兼末>Ｌ
潘	氵丿田Ｐ
嗦	口十小Ｓ
祈	礻斤ＱＩ
灼	火勹丶Ｚ
瞥	丷攵目Ｐ
斑	王文王Ｂ
顽	元页ＷＮ
兹	<首上>幺幺Ｚ
糕	米灬Ｇ
昊	日一大Ｈ
锅	钅口内Ｇ
缚	纟甫寸Ｆ
妞	女丑ＮＵ
匠	匚斤ＪＧ
魁	白<见下>斗Ｋ
鹤	冖隹鸟Ｈ
绯	纟非ＦＩ
谎	讠艹<流角>Ｈ
榜	木<旁上>方Ｂ
碌	石<录上>水Ｌ
拂	扌弓<齐下>Ｆ
壶	士冖业Ｈ
昧	日未ＭＩ
遁	十辶Ｄ
蔽	艹巾攵Ｂ
庙	广由ＭＯ
蹄	<旁上>巾Ｔ
茜	艹西ＸＩ
腔	月穴工Ｑ
堕	阝土Ｄ
耽	耳<巾变>乚Ｄ
硕	石页ＳＯ
壳	士冖几Ｋ
彪	虍几彡Ｂ
肠	月<乃上><两撇>Ｃ
钰	钅王丶Ｙ
岭	山今丶Ｌ
嗡	口八羽Ｗ
栋	木<东上>小Ｄ
葬	艹歹廾Ｚ
冉	冂土ＲＮ
挪	扌<那左>阝Ｎ
鞋	革圭ＸＥ
蹦	山月Ｂ
柴	止匕木Ｃ
蔓	艹日又Ｍ
陀	阝宀匕Ｔ
姊	女丿<亏下>Ｚ
啧	口贝Ｚ
妨	女方ＦＧ
窃	穴七刀Ｑ
阎	门臼Ｙ
盆	八刀皿Ｐ
焚	林火ＦＮ
矢	矢ＳＩ丿
携	扌隹乃Ｘ
钉	钅丁ＤＧ
帘	穴巾ＬＮ
俺	亻大乚Ａ
嗤	口屮虫Ｃ
萝	艹罒夕Ｌ
沧	氵人Ｃ
循	彳目Ｘ
搅	扌<学上>见Ｊ
渺	氵目少Ｍ
兀	一儿ＷＵ
狭	犭夫丷Ｘ
戟	十十戈Ｊ
申	日丨ＳＮ
翘	<尧上>儿羽Ｑ
嘱	口尸冂Ｚ
拆	扌斤丶Ｃ
津	氵<秉中><举下>Ｊ
贱	贝一戈Ｊ
汝	氵女ＲＵ
暇	日<右框>又Ｘ
愉	忄亼<前下>Ｙ
侄	亻至ＺＩ
棵	木日木Ｋ
谭	讠覀十Ｔ
轨	<车旁>九ＧＩ
蚁	虫丶乂Ｙ
啥	口亼古Ｓ
媒	女廿木Ｍ
噗	口业丶Ｐ
锻	钅<段左>殳Ｄ
赴	走卜ＦＵ
诈	讠乍ＺＡ
巢	巛日木Ｃ
捡	扌亼<应下>Ｊ
哟	口纟勹Ｙ
衷	亠中<衣下>Ｚ
吁	口于ＹＵ
彦	立丿彡Ｙ
渗	氵厶彡Ｓ
峡	山夫丷Ｘ
涡	氵口内Ｗ
禅	礻丷十Ｃ
氓	亡巳七Ｍ
浆	丬夕水Ｊ
租	禾且ＺＵ
阅	门丷口Ｙ
掐	扌臼Ｑ
帽	巾<冒上>目Ｍ
揭	扌日勹Ｊ
妒	女户ＤＵ
毙	比歹匕Ｂ
寞	宀莫ＭＯ
孝	耂子ＸＯ
乙	乙ＹＩ乛
贸	<卬左>刀贝Ｍ
革	革ＧＥ一
喔	口尸至Ｗ
憋	丷攵心Ｂ
蓄	艹玄田Ｘ
坎	土欠ＫＮ
舅	臼田力Ｊ
絮	女口小Ｘ
烛	火虫ＺＵ
歆	音欠ＸＮ
胞	月勹巳Ｂ
翰	十十羽Ｈ
颖	匕禾页Ｙ
彤	<周框>亠彡Ｔ
唔	口五口Ｗ
垃	土立ＬＡ
圾	土及ＪＩ
尧	<尧上>一儿Ｙ
旭	九日ＸＵ
寄	宀大可Ｊ
喀	口宀各Ｋ
遂	<首上>豕辶Ｓ
阱	阝井ＪＧ
泊	氵白ＢＯ
妾	立女ＱＥ
瑰	王白<见下>Ｇ
虐	虍<虐下>ＮＥ
潭	氵覀十Ｔ
祀	礻巳ＳＩ
逻	罒夕辶Ｌ
璇	王<旗角><足下>Ｘ
税	禾丷儿Ｓ
嫂	女叟ＳＯ
填	土十八Ｔ
蛟	虫亠父Ｊ
怯	忄土厶Ｑ
滔	氵爫臼Ｔ
弧	弓瓜ＨＵ
惫	夂田心Ｂ
煌	火白王Ｈ
雍	亠丿隹Ｙ
衍	彳氵亍Ｙ
笛	由ＤＩ
庸	广<秉中>冃Ｙ
兆	<兆左><兆右>ＺＯ
咚	口夂<冬下>Ｄ
暮	莫日ＭＵ
卜	卜ＢＵ丨
裳	口<衣下>Ｓ
沫	氵末ＭＯ
蝎	虫日勹Ｘ
寡	宀丆刀Ｇ
蚀	饣虫ＳＩ
枉	木王ＷＧ
粹	米亠十Ｃ
澡	氵口木Ｚ
昔	日ＸＩ
摘	扌<商外>古Ｚ
瀚	氵人羽Ｈ
寝	宀丬又Ｑ
熙	匚巳灬Ｘ
舜	<爱上>夕<舛右>Ｓ
售	隹口ＳＵ
栽	十戈木Ｚ
胧	月龙ＬＧ
贞	<卓上>贝ＺＮ
诅	讠且ＺＵ
滩	氵又隹Ｔ
韧	二<韦下>刀Ｒ
倚	亻大可Ｙ
睹	目者ＤＵ
栈	木一戈Ｚ
蝠	虫畐ＦＵ
桶	木<甬下>Ｔ
卦	圭卜ＧＡ
臀	尸殳冃Ｔ
狰	犭亅Ｚ
姚	女<兆左><兆右>Ｙ
雇	户隹ＧＵ
署	罒者ＳＵ
狙	犭且ＪＵ
泼	氵发ＰＯ
诛	讠朱ＺＵ
朦	月艹<豕下>Ｍ
栏	木<首上>二Ｌ
筒	冂一Ｔ
哧	口土<赤下>Ｃ
溪	氵爫大Ｘ
册	册ＣＥ丿
窥	穴夫见Ｋ
湘	氵相ＸＧ
犀	尸氺牛Ｘ
舔	舌一Ｔ
剥	<录上>水刂Ｂ
磁	石<首上>幺Ｃ
惕	忄日勹Ｔ
旷	日广ＫＧ
佑	亻口Ｙ
歼	歹千ＪＮ
兜	<卬左><右框>儿Ｄ
窟	穴尸山Ｋ
枕	木<巾变>乚Ｚ
囚	囗人ＱＵ
裴	非亠<衣下>Ｐ
胀	月长ＺＧ
楠	木<南上><首上>Ｎ
觑	虍业见Ｑ
擂	扌<雨头>田Ｌ
拽	扌日乚Ｚ
捣	扌<鸟上>山Ｄ
蕊	艹心心Ｒ
巷	八巳Ｘ
乞	乙ＱＩ
谱	讠<首上>日Ｐ
蚩	屮一虫Ｃ
哩	口里ＬＩ
琢	王豕丶Ｚ
垒	厶厶土Ｌ
胃	田冃ＷＩ
虞	虍口大Ｙ
绣	纟禾乃Ｘ
衰	亠口<衣下>Ｓ
扁	户冊ＢＮ
菩	艹立口Ｐ
颅	<卓上>尸页Ｌ
骆	马各ＬＯ
抄	扌少ＣＯ
菁	艹月Ｊ
纽	纟丑ＮＵ
贡	工贝ＧＧ
噢	口<向框>大Ｏ
桓	木一一Ｈ
绮	纟大可Ｑ
戚	戊<卓上>一Ｑ
惟	忄隹ＷＩ
慑	忄耳又Ｓ
罡	罒一止Ｇ
喧	口宀一Ｘ
衙	彳五亍Ｙ
瑜	王亼<前下>Ｙ
岗	山冂乂Ｇ
侃	亻口<流角>Ｋ
祷	礻<丰变>寸Ｄ
萍	<艹氵>干丷Ｐ
剂	文<齐下>刂Ｊ
莽	艹大廾Ｍ
诞	讠丿廴Ｄ
轴	<车旁>由ＺＵ
嘘	口虍业Ｘ
烫	氵<乃上>火Ｔ
咙	口龙ＬＧ
鞘	革冃Ｑ
丞	乛水一Ｃ
剿	巛木刂Ｊ
孽	艹<阜上>子Ｎ
淘	氵勹缶Ｔ
翎	今丶羽Ｌ
翁	八厶羽Ｗ
恕	女口心Ｓ
衬	衤寸ＣＮ
倦	亻Ｊ
揽	扌<半竹>见Ｌ
疚	疒丶Ｊ
轿	<车旁>丿<齐下>Ｊ
秃	禾几ＴＵ
猾	犭骨ＨＡ
钦	钅欠ＱＮ
嗜	口耂日Ｓ
掷	扌丷阝Ｚ
藉	艹耒日Ｊ
鸦	一<牙下>鸟Ｙ
陨	阝口贝Ｙ
熬	敖灬ＡＯ
窍	穴工丂Ｑ
郝	土<赤下>阝Ｈ
芷	艹止ＺＩ
咖	口加ＫＡ
勋	口贝力Ｘ
铸	钅<丰变>寸Ｚ
叨	口刀ＤＯ
乍	乍ＺＡ丿
磕	石土皿Ｋ
扳	扌又Ｂ
霎	<雨头>立女Ｓ
姥	女耂匕Ｌ
棺	木宀<官下>Ｇ
奢	大者ＳＥ
辟	尸口辛Ｂ
叙	亼朩又Ｘ
畜	玄田ＸＵ
嫉	女疒矢Ｊ
蜘	虫矢口Ｚ
搁	扌门各Ｇ
钥	钅月ＹＥ
陋	阝一乚Ｌ
茅	艹<矛下>Ｍ
倏	亻夂大Ｓ
瘫	疒又隹Ｔ
菊	艹勹米Ｊ
匙	日<足下>匕Ｃ
翩	户冊羽Ｐ
倘	亻冂Ｔ
擎	艹攵手Ｑ
趋	走彐Ｑ
窄	穴乍ＺＩ
峻	山厶夂Ｊ
啡	口非ＦＩ
嗽	口木欠Ｓ
醋	酉日Ｃ
酥	酉禾ＳＵ
伺	亻一Ｓ
恳	艮心ＫＮ
粘	米占ＮＮ
哆	口夕夕Ｄ
绞	纟亠父Ｊ
绷	纟月月Ｂ
丐	一<卓上><亏下>Ｇ
渠	氵匚木Ｑ
娱	女口大Ｙ
佘	人示ＳＥ
淌	氵冂Ｔ
履	尸彳夂Ｌ
塑	<首上>月土Ｓ
症	疒一止Ｚ
衔	彳钅亍Ｘ
蔑	艹罒戊Ｍ
禽	人文冂Ｑ
傀	亻白<见下>Ｋ
蛊	虫皿ＧＵ
炀	火<乃上><两撇>Ｙ
捞	扌艹力Ｌ
蒸	艹乛灬Ｚ
缄	纟戊一Ｊ
嗖	口叟ＳＵ
炫	火玄ＸＮ
眩	目玄ＸＮ
歧	止十又Ｑ
邱	丘阝ＱＵ
挟	扌夫丷Ｘ
帆	巾几丶Ｆ
莺	艹冖鸟Ｙ
渔	氵鱼ＹＵ
敞	冂攵Ｃ
绰	纟<卓上>十Ｃ
淳	氵<享上>子Ｃ
厥	厂丷欠Ｊ
瞟	目覀示Ｐ
霹	<雨头>尸辛Ｐ
疤	疒巴ＢＡ
柏	木白ＢＩ
徽	<微框>幺小Ｈ
讪	讠山ＳＮ
猿	犭土<衣下>Ｙ
沮	氵且ＪＵ
眶	目匚王Ｋ
页	页ＹＥ一
卸	止卩Ｘ
宵	宀冃Ｘ
惭	忄<车旁>斤Ｃ
菱	艹土夂Ｌ
踹	山<而下>Ｃ
肿	月中ＺＧ
萱	艹宀一Ｘ
斐	非文ＦＩ
钩	钅勹厶Ｇ
瓷	冫欠瓦Ｃ
雳	<雨头>厂力Ｌ
茂	艹戊ＭＯ
肺	月一巾Ｆ
届	尸由ＪＥ
鹫	<享上>丶鸟Ｊ
碑	石卑ＢＩ
儡	亻田田Ｌ
蝉	虫丷十Ｃ
夭	丿大ＹＯ
娟	女口冃Ｊ
曰	曰ＹＥ丨
淮	氵隹ＨＩ
拘	扌勹口Ｊ
搓	扌工Ｃ
捅	扌<甬下>Ｔ
豁	宀口<谷下>Ｈ
亨	<享上>乛亅Ｈ
荐	艹<在角>子Ｊ
漩	氵<旗角><足下>Ｘ
捆	扌囗木Ｋ
沼	氵刀口Ｚ
迭	失辶ＤＥ
侮	亻母Ｗ
叱	口<化右>ＣＩ
槐	木白<见下>Ｈ
迸	丷开辶Ｂ
扛	扌工ＫＧ
屡	尸米女Ｌ
鲍	鱼勹巳Ｂ
脊	<脊左><脊右>月Ｊ
忖	忄寸ＣＮ
婢	女卑ＢＩ
栗	覀木ＬＩ
驼	马宀匕Ｔ
贩	贝又Ｆ
芦	艹户ＬＵ
拎	扌今丶Ｌ
彬	林彡ＢＮ
姗	女册ＳＮ
淹	氵大乚Ｙ
怠	厶口心Ｄ
钧	钅勹冫Ｊ
嗅	口自大Ｘ
樊	木木大Ｆ
弛	弓也ＣＩ
霓	<雨头>臼儿Ｎ
揍	扌大Ｚ
喽	口米女Ｌ
汁	氵十ＺＩ
惮	忄丷十Ｄ
邻	今丶阝Ｌ
蟒	虫艹廾Ｍ
衅	丿皿半Ｘ
瘾	疒阝心Ｙ
账	贝长ＺＧ
览	<临左><半竹>见Ｌ
妩	女<干变>乚Ｗ
厦	厂丆夂Ｘ
妆	丬女ＺＧ
芊	艹千ＱＮ
抿	扌巳七Ｍ
喻	口亼<前下>Ｙ
吏	丈口ＬＩ
澈	氵<充上>攵Ｃ
砖	石二<专下>Ｚ
僻	亻尸辛Ｐ
倪	亻臼儿Ｎ
挫	扌从土Ｃ
杏	木口ＸＧ
襄	亠吅<衣下>Ｘ
桐	木冂一Ｔ
矣	厶矢ＹＩ
噩	王吅吅Ｅ
揪	扌禾火Ｊ
拧	扌宀丁Ｎ
燥	火口木Ｚ
郊	亠父阝Ｊ
喇	口木刂Ｌ
沦	氵人匕Ｌ
蚂	虫马ＭＡ
阮	阝元ＲＮ
帖	巾占ＴＥ
戬	亚日戈Ｊ
铲	钅立丿Ｃ
孕	乃子ＹＮ
跺	几木Ｄ
巅	山八页Ｄ
敦	<享上>子攵Ｄ
婪	林女ＬＮ
蹈	爫臼Ｄ
蹭	丷日Ｃ
株	木朱ＺＵ
凹	凹ＡＯ丨
婿	女乛冃Ｘ
嬉	女吉口Ｘ
盐	土卜皿Ｙ
冀	<北左>匕八Ｊ
膜	月莫ＭＯ
剪	<首上><前下>刀Ｊ
鞠	革勹米Ｊ
桂	木圭ＧＩ
盏	一戈皿Ｚ
襟	衤林示Ｊ
逞	口王辶Ｃ
棘	木冂木Ｊ
焉	一<亏下>灬Ｙ
跋	犮ＢＡ
呕	口匚乂Ｏ
稚	禾隹ＺＩ
嵌	山廿欠Ｑ
熠	火羽白Ｙ
颓	禾几页Ｔ
妓	女十又Ｊ
穹	穴弓ＱＧ
邵	刀口阝Ｓ
涣	氵大Ｈ
债	亻贝Ｚ
梧	木五口Ｗ
勿	勹<两撇>ＷＵ
墟	土虍业Ｘ
焱	火火火Ｙ
桩	木广土Ｚ
脯	月甫ＦＵ
镶	钅亠<衣下>Ｘ
拭	扌弋工Ｓ
忿	八刀心Ｆ
撩	扌大小Ｌ
涟	氵车辶Ｌ
谍	讠世木Ｄ
拇	扌母ＭＵ
瑾	王廿Ｊ
疫	疒殳ＹＩ
掘	扌尸山Ｊ
梨	禾刂木Ｌ
窒	穴至ＺＩ
朽	木丂ＸＵ
奕	亠<赤下>大Ｙ
涅	氵日土Ｎ
顷	<比左>页ＱＧ
咋	口乍ＺＡ
酬	酉州ＣＵ
琦	王大可Ｑ
蝙	虫户冊Ｂ
吭	口亠几Ｋ
僚	亻大小Ｌ
镰	钅广<兼末>Ｌ
砚	石见ＹＮ
瞅	目禾火Ｃ
饥	饣几ＪＩ
邸	<卬左>七阝Ｄ
漾	氵<永下>Ｙ
婕	女一<足下>Ｊ
胤	儿幺月Ｙ
呸	口不一Ｐ
译	讠又<举下>Ｙ
峙	山土寸Ｚ
寥	宀羽彡Ｌ
凸	凸ＴＵ丨
垫	执土ＤＮ
肋	月力ＬＩ
噜	口鱼日Ｌ
漓	氵文冂Ｌ
剔	日<两撇>刂Ｔ
猩	犭日Ｘ
梳	木<充上><流角>Ｓ
峨	山手戈Ｅ
熄	火自心Ｘ
睿	<卓上>冖目Ｒ
禹	丿虫冂Ｙ
址	土止ＺＩ
蝴	虫古月Ｈ
萌	艹日月Ｍ
瞻	目言Ｚ
眷	目ＪＮ
蹬	癶<首上>Ｄ
绘	纟人云Ｈ
龚	龙八Ｇ
岔	八刀山Ｃ
唬	口虍几Ｈ
飙	大大风Ｂ
驭	马又ＹＵ
漪	氵大可Ｙ
侥	亻<尧上>儿Ｊ
肘	月寸ＺＵ
侣	亻口口Ｌ
熏	千黑ＸＮ
螺	虫田小Ｌ
聘	耳由丂Ｐ
唾	口千<垂下>Ｔ
幢	巾立里Ｃ
揣	扌山<而下>Ｃ
坊	土方ＦＧ
湛	氵其乚Ｚ
谊	讠宀且Ｙ
箫	<秉中><肃下>Ｘ
沛	氵一巾Ｐ
垮	土大<亏下>Ｋ
妲	女日一Ｄ
鹃	口冃鸟Ｊ
翡	非羽ＦＩ
琐	王贝Ｓ
髓	骨辶Ｓ
讥	讠几ＪＩ
裕	衤八<谷下>Ｙ
薪	艹立斤Ｘ
毯	毛火火Ｔ
骸	骨亥ＨＩ
癸	癶一大Ｇ
苹	艹干丷Ｐ
匿	匚艹Ｎ
脂	月匕日Ｚ
玑	王几ＪＩ
澎	氵吉彡Ｐ
枢	木匚乂Ｓ
懈	忄刀牛Ｘ
宪	宀儿Ｘ
搀	扌<冬下>Ｃ
皓	白口Ｈ
悸	忄禾子Ｊ
嗷	口敖ＡＯ
跄	人Ｑ
镯	钅罒勹Ｚ
膨	月吉彡Ｐ
憨	乛攵心Ｈ
瓣	<辛变>瓜辛Ｂ
泻	氵冖<亏下>Ｘ
踉	丶艮Ｌ
黝	黑幺力Ｙ
葫	艹古月Ｈ
渣	氵木一Ｚ
麾	广林毛Ｈ
酿	酉丶艮Ｎ
詹	厂言Ｚ
沁	氵心ＱＮ
眈	目<巾变>乚Ｄ
畔	田半ＰＮ
懊	忄<向框>大Ａ
熔	火宀<谷下>Ｒ
筷	忄夬Ｋ
霖	<雨头>林ＬＮ
综	纟宀示Ｚ
傍	亻<旁上>方Ｂ
瑕	王<右框>又Ｘ
刁	一ＤＯ
嚓	口宀示Ｃ
惚	忄勹心Ｈ
践	一戈Ｊ
兢	古儿儿Ｊ
尿	尸水ＮＯ
秉	禾<秉中>ＢＧ
伞	人丷十Ｓ
崆	山穴工Ｋ
棉	木白巾Ｍ
媳	女自心Ｘ
坟	土文ＦＮ
鹅	手戈鸟Ｅ
瀑	氵日氺Ｐ
鲸	鱼<享上>小Ｊ
逮	彐水辶Ｄ
糖	米广口Ｔ
缉	纟口耳Ｊ
稻	禾爫臼Ｄ
暧	日<爱上>又Ａ
奎	大圭ＫＩ
绸	纟<周框>土Ｃ
隋	阝冃Ｓ
狩	犭宀寸Ｓ
湃	氵一丰Ｐ
叽	口几ＪＩ
饼	饣丷开Ｂ
靡	广林非Ｍ
锥	钅隹ＺＩ
碟	石世木Ｄ
拙	扌凵山Ｚ
簇	<旗角>矢Ｃ
蝇	虫口乚Ｙ
蚕	一大虫Ｃ
叩	口卩ＫＵ
咸	戊一口Ｘ
亢	亠几ＫＧ
澄	氵癶<首上>Ｃ
骏	马厶夂Ｊ
辖	<车旁>宀口Ｘ
媛	女爫又Ｙ
姻	女囗大Ｙ
扒	扌八ＢＡ
赠	贝丷日Ｚ
秩	禾失ＺＩ
朔	丷<屮变>月Ｓ
倔	亻尸山Ｊ
嚼	口爫寸Ｊ
卵	<卯左><冬下>卩Ｌ
胶	月亠父Ｊ
绚	纟勹日Ｘ
镔	钅穴丘Ｂ
蚊	虫文ＷＮ
唧	口<即左>卩Ｊ
炯	火冂口Ｊ
罐	缶艹隹Ｇ
浊	氵虫ＺＯ
冶	冫厶口Ｙ
讳	讠二<韦下>Ｈ
杭	木亠几Ｈ
弊	丷攵廾Ｂ
戳	羽隹戈Ｃ
禄	礻<录上>水Ｌ
斋	文丆<而下>Ｚ
搐	扌玄田Ｃ
炙	<然角>火ＺＩ
佬	亻耂匕Ｌ
聋	龙耳ＬＧ
厄	厂ＥＥ
凳	癶一几Ｄ
鲨	氵少鱼Ｓ
驴	马户ＬＵ
盲	亡目ＭＧ
锢	钅囗古Ｇ
锡	钅日勹Ｘ
诏	讠刀口Ｚ
伽	亻加ＪＡ
铮	钅亅Ｚ
缭	纟大小Ｌ
鸭	甲鸟ＹＡ
捶	扌千<垂下>Ｃ
唰	口尸刂Ｓ
搔	扌又虫Ｓ
滥	氵<半竹>皿Ｌ
恙	心ＹＧ
谜	讠米辶Ｍ
啃	口止冃Ｋ
啼	口<旁上>巾Ｔ
驯	马川ＸＮ
匣	匚甲ＸＡ
悯	忄门文Ｍ
鸾	<变上>鸟ＬＮ
杉	木彡ＳＮ
煜	火日立Ｙ
拣	扌<东上><拣角>Ｊ
拯	扌乛一Ｚ
偎	亻田<畏下>Ｗ
呛	口人Ｑ
绅	纟日丨Ｓ
屿	山与ＹＵ
煮	者灬ＺＵ
璐	王各Ｌ
冈	冂乂ＧＧ
甄	覀土瓦Ｚ
匈	勹乂凵Ｘ
钓	钅勹丶Ｄ
咔	口<卓上>下Ｋ
笙	丿Ｓ
桀	夕<舛右>木Ｊ
蜥	虫木斤Ｘ
囔	口十<衣下>Ｎ
缴	纟白攵Ｊ
喳	口木一Ｚ
泳	氵丶<永下>Ｙ
睬	目爫木Ｃ
祟	凵山示Ｓ
崎	山大可Ｑ
谣	讠爫缶Ｙ
晖	日冖车Ｈ
炭	山火Ｔ
忑	下心ＴＥ
栖	木西ＱＩ
娴	女门木Ｘ
忐	<卓上>一心Ｔ
榕	木宀<谷下>Ｒ
堤	土日<足下>Ｄ
哽	口一乂Ｇ
烬	火尺<冬下>Ｊ
炒	火少ＣＯ
棱	木土夂Ｌ
肝	月干ＧＮ
靴	革亻<化右>Ｘ
痞	疒不口Ｐ
阀	门亻戈Ｆ
缪	纟羽彡Ｍ
赦	土<赤下>攵Ｓ
殖	歹十<具上>Ｚ
纲	纟冂乂Ｇ
璧	尸辛王Ｂ
厘	厂里ＬＩ
泓	氵弓厶Ｈ
涕	氵丷弓Ｔ
壤	土亠<衣下>Ｒ
懿	士<首上>心Ｙ
闺	门圭ＧＩ
浇	氵<尧上>儿Ｊ
匀	勹冫ＹＮ
棚	木月月Ｐ
娲	女口内Ｗ
蔚	艹尸寸Ｗ
稽	禾丶日Ｊ
虾	虫下ＸＡ
劭	刀口力Ｓ
茨	艹冫欠Ｃ
戾	户大丶Ｌ
橙	木癶<首上>Ｃ
厕	厂贝刂Ｃ
捐	扌口冃Ｊ
瘟	疒日皿Ｗ
舵	舟宀匕Ｄ
芯	艹心ＸＮ
晒	日西ＳＩ
烙	火各ＬＯ
驸	马亻寸Ｆ
亵	亠<衣下>执Ｘ
颂	八厶页Ｓ
钝	钅七凵Ｄ
窘	穴丿口Ｊ
懦	忄<雨头><而下>Ｎ
稷	禾田夂Ｊ
赎	贝十头Ｓ
袅	<鸟上>亠<衣下>Ｎ
庶	广廿灬Ｓ
腮	月田心Ｓ
绢	纟口冃Ｊ
葱	艹勹心Ｃ
溶	氵宀<谷下>Ｒ
榻	木日羽Ｔ
吨	口七凵Ｄ
貂	豸刀口Ｄ
哉	十戈口Ｚ
娥	女手戈Ｅ
悚	忄木口Ｓ
虔	虍文ＱＮ
蹙	戊<卓上>足Ｃ
婶	女宀丨Ｓ
屎	尸米ＳＩ
磋	石工Ｃ
殆	歹厶口Ｄ
诩	讠羽ＸＵ
蠕	虫<雨头><而下>Ｒ
偌	亻艹口Ｒ
拚	扌厶廾Ｐ
骼	骨各ＧＥ
觅	爫见ＭＩ
旱	日干ＨＮ
裔	亠<衣下>冂Ｙ
昱	日立ＹＵ
冕	<冒上><见下>Ｍ
屯	七凵ＴＮ
惋	忄宀Ｗ
萎	艹禾女Ｗ
苑	艹夕Ｙ
枭	<鸟上>木ＸＯ
惺	忄日Ｘ
砂	石少ＳＡ
殴	匚乂殳Ｏ
叭	口八ＢＡ
梢	木冃Ｓ
缨	纟贝女Ｙ
蹿	穴丨Ｃ
飓	风<具上>八Ｊ
峭	山冃Ｑ
甸	勹田ＤＮ
谐	讠比白Ｘ
澳	氵<向框>大Ａ
聆	耳今丶Ｌ
腊	月日Ｌ
缜	纟十八Ｚ
帜	巾口八Ｚ
昼	尺日一Ｚ
滕	月氺Ｔ
茧	艹虫ＪＮ
绫	纟土夂Ｌ
汰	氵大丶Ｔ
皙	木斤白Ｘ
踱	广又Ｄ
嵩	山<高外>口Ｓ
兑	丷口儿Ｄ
诊	讠人彡Ｚ
葡	艹勹甫Ｐ
筝	亅Ｚ
邃	穴<首上>辶Ｓ
辑	<车旁>口耳Ｊ
獠	犭大小Ｌ
昕	日斤ＸＮ
蜡	虫日Ｌ
奄	大日乚Ｙ
诵	讠<甬下>Ｓ
腑	月广寸Ｆ
悻	忄土十Ｘ
憎	忄丷日Ｚ
嗨	口母Ｈ
敷	甫方攵Ｆ
庇	广比ＢＩ
榴	木刀田Ｌ
晦	日母Ｈ
祢	礻小Ｍ
荀	艹勹日Ｘ
慷	忄广水Ｋ
寓	宀甲冂Ｙ
茉	艹末ＭＯ
咄	口凵山Ｄ
曙	日罒者Ｓ
噪	口吅木Ｚ
吒	口丿七Ｚ
缸	缶工ＧＧ
幡	巾丿田Ｆ
啤	口卑ＰＩ
烨	火<化右>十Ｙ
忡	忄中ＣＧ
粥	弓米弓Ｚ
悴	忄亠十Ｃ
咏	口丶<永下>Ｙ
颔	今口页Ｈ
洽	氵亼口Ｑ
募	莫力ＭＵ
驿	马又<举下>Ｙ
藩	<艹氵>丿田Ｆ
靶	革巴ＢＡ
谬	讠羽彡Ｍ
憔	忄隹灬Ｑ
邹	彐阝Ｚ
痹	疒田丌Ｂ
绊	纟半ＢＮ
酋	酋ＱＵ丶
框	木匚王Ｋ
茄	艹加ＱＥ
挚	执手ＺＩ
萄	艹勹缶Ｔ
恬	忄舌ＴＮ
聿	<秉中><举下>ＹＵ
檀	木亠一Ｔ
凿	业<首上>凵Ｚ
璋	王音十Ｚ
钞	钅少ＣＯ
褐	衤日勹Ｈ
蟹	刀虫Ｘ
鬟	镸彡<衣下>Ｈ
铛	钅彐Ｃ
曦	日戈Ｘ
崽	山田心Ｚ
胯	月大<亏下>Ｋ
璀	王山隹Ｃ
菇	艹女古Ｇ
眺	目<兆左><兆右>Ｔ
瘩	疒艹口Ｄ
璨	王又米Ｃ
抡	扌人匕Ｌ
斟	其乚斗Ｚ
褪	衤艮辶Ｔ
涎	氵丿廴Ｘ
勺	勹丶ＳＯ
溟	氵冖八Ｍ
疙	疒乙Ｇ
坪	土干丷Ｐ
猥	犭田<畏下>Ｗ
塘	土广口Ｔ
揖	扌口耳Ｙ
逾	亼<前下>辶Ｙ
冽	冫歹刂Ｌ
遏	日勹辶Ｅ
芽	艹一<牙下>Ｙ
裘	<求架>丶<衣下>Ｑ
徊	彳囗口Ｈ
函	乛氺凵Ｈ
槽	木<曹上>日Ｃ
蟾	虫言Ｃ
睫	目一<足下>Ｊ
珂	王可ＫＥ
嘭	口吉彡Ｐ
蒲	<艹氵>甫ＰＵ
煎	<首上><前下>灬Ｊ
庚	广<秉中>人Ｇ
荫	艹阝月Ｙ
稿	禾<高外>口Ｇ
徘	彳非ＰＩ
蛙	虫圭ＷＡ
睽	目癶大Ｋ
廓	广<享上>阝Ｋ
滨	氵穴丘Ｂ
彰	音十彡Ｚ
锵	钅夕寸Ｑ
掺	扌厶彡Ｃ
缰	纟一一Ｊ
芭	艹巴ＢＡ
嗒	口艹口Ｄ
嘈	口<曹上>日Ｃ
暄	日宀一Ｘ
琅	王丶艮Ｌ
萤	艹冖虫Ｙ
旬	勹日ＸＮ
翱	白十羽Ａ
栅	木册ＺＡ
缈	纟目少Ｍ
猝	犭亠十Ｃ
魇	厂大<见下>Ｙ
攒	扌贝Ｚ
蜴	虫日勹Ｙ
鞑	革大辶Ｄ
窿	穴阝Ｌ
扈	户口巴Ｈ
蜷	虫Ｑ
秽	禾山夕Ｈ
崛	山尸山Ｊ
谕	讠亼<前下>Ｙ
袱	衤大丶Ｆ
瑚	王古月Ｈ
磅	石<旁上>方Ｂ
缔	纟<旁上>巾Ｄ
攸	亻丨攵Ｙ
缥	纟覀示Ｐ
惬	忄匚夫Ｑ
撅	扌厂欠Ｊ
钮	钅丑ＮＵ
阙	门丷<屮变>Ｑ
鸽	亼口鸟Ｇ
葵	艹癶大Ｋ
曳	日乚丿Ｙ
蔼	艹讠勹Ａ
礁	石隹灬Ｊ
苛	艹可ＫＥ
佗	亻宀匕Ｔ
庐	广户ＬＵ
珀	王白ＰＯ
稠	禾<周框>土Ｃ
娉	女由丂Ｐ
嗣	口冊Ｓ
饵	饣耳ＥＲ
耕	耒井ＧＧ
肴	乂冃Ｙ
渎	氵十头Ｄ
嵋	山<声下>目Ｍ
伶	亻今丶Ｌ
瑭	王广口Ｔ
懵	忄艹目Ｍ
饷	饣<向框>口Ｘ
韬	二<韦下>臼Ｔ
恃	忄土寸Ｓ
浦	氵甫ＰＵ
邢	开阝ＸＧ
咻	口亻木Ｘ
隧	阝<首上>辶Ｓ
贷	代贝ＤＩ
滢	氵艹王Ｙ
掳	扌虍力Ｌ
颁	八刀页Ｂ
芜	艹<干变>乚Ｗ
檐	木言Ｙ
祯	礻<卓上>贝Ｚ
吝	文口ＬＮ
蘑	艹广石Ｍ
咫	尺口八Ｚ
茬	艹<在角>土Ｃ
怦	忄干丷Ｐ
缀	纟又又Ｚ
扼	扌厂Ｅ
唠	口艹力Ｌ
趾	止ＺＩ
殃	歹央ＹＧ
噼	口尸辛Ｐ
掂	扌广占Ｄ
啐	口亠十Ｃ
羌	乚ＱＧ
畴	田<丰变>寸Ｃ
枷	木加ＪＡ
捺	扌大示Ｎ
禾	禾ＨＥ丿
绒	纟戈Ｒ
邮	由阝ＹＵ
辙	<车旁><充上>攵Ｚ
籁	木贝Ｌ
煽	火户羽Ｓ
戎	戈ＲＧ
糙	米辶Ｃ
漱	氵木欠Ｓ
竿	干ＧＮ
瘪	疒自匕Ｂ
矫	矢丿<齐下>Ｊ
汀	氵丁ＴＧ
吆	口幺ＹＯ
怅	忄长ＣＧ
攘	扌亠<衣下>Ｒ
叼	口一Ｄ
昵	日尸匕Ｎ
烽	火夂丰Ｆ
猖	犭日日Ｃ
芥	艹人<齐下>Ｊ
紊	文幺小Ｗ
甬	<甬下>ＹＧ
跷	<尧上>儿Ｑ
靓	月见Ｌ
栩	木羽ＸＵ
簌	木欠Ｓ
寐	宀爿未Ｍ
壕	土<亮上>豕Ｈ
侈	亻夕夕Ｃ
嫡	女<商外>古Ｄ
黏	禾氺占Ｎ
亩	亠田ＭＵ
酣	酉廿一Ｈ
舆	<臼裂>车八Ｙ
痊	疒人王Ｑ
娆	女<尧上>儿Ｒ
侏	亻朱ＺＵ
佯	亻羊ＹＧ
锣	钅罒夕Ｌ
佼	亻亠父Ｊ
羲	丂戈Ｘ
棣	木彐水Ｄ
鳄	鱼吅<亏下>Ｅ
惘	忄冂<首上>Ｗ
霏	<雨头>非ＦＩ
媲	女<囱框>比Ｐ
蔷	艹十囗Ｑ
篝	<冓上>冂Ｇ
蛤	虫亼口Ｇ
虬	虫乚ＱＵ
荧	艹冖火Ｙ
舷	舟玄ＸＮ
螂	虫丶阝Ｌ
溺	氵弓弓Ｎ
羿	羽廾ＹＩ
巳	巳ＳＩ乛
仕	亻士ＳＩ
攥	扌小Ｚ
桦	木<化右>十Ｈ
氧	气羊ＹＧ
殇	歹<乃上>Ｓ
捻	扌今心Ｎ
胄	由冃ＺＵ
臧	戊乚丆Ｚ
萦	艹冖小Ｙ
漉	氵<鹿上>比Ｌ
骋	马由丂Ｃ
券	刀ＱＮ
贬	贝丿之Ｂ
瑛	王艹央Ｙ
迂	于辶ＹＵ
晟	日戊Ｓ
雏	彐隹Ｃ
勘	其乚力Ｋ
煤	火廿木Ｍ
坞	土乌ＷＵ
衮	亠八<衣下>Ｇ
蓓	艹亻口Ｂ
蹂	木Ｒ
蜒	虫丿廴Ｙ
忒	弋心ＴＥ
晏	日宀女Ｙ
牡	牜土ＭＵ
札	木乚ＺＡ
缎	纟<段左>殳Ｄ
膏	<亮上>口月Ｇ
屹	山乙Ｙ
肮	月亠几Ａ
哒	口大辶Ｄ
煦	日勹灬Ｘ
棕	木宀示Ｚ
糜	广林米Ｍ
瞠	目土Ｃ
筱	亻攵Ｘ
躏	艹门Ｌ
臻	至禾Ｚ
淤	氵人<冬下>Ｙ
瀛	氵<赢框>女Ｙ
蹊	爫大Ｑ
孰	<享上>子九Ｓ
沪	氵户ＨＵ
浙	氵扌斤Ｚ
毗	田比ＰＩ
呱	口瓜ＧＡ
磐	舟殳石Ｐ
矜	<矛下>今Ｇ
幺	幺ＹＯ乛
俨	亻亚丿Ｙ
琥	王虍几Ｈ
胴	月冂一Ｄ
暑	日者ＳＵ
雌	止匕隹Ｃ
锯	钅尸古Ｊ
硝	石冃Ｘ
酱	丬夕酉Ｊ
喋	口世木Ｄ
箍	扌匚Ｇ
婧	女月Ｊ
玺	小王Ｘ
羁	罒革马Ｊ
骁	马<尧上>儿Ｘ
拈	扌占ＮＮ
迢	刀口辶Ｔ
衲	衤内ＮＡ
呗	口贝ＢＩ
钵	钅木一Ｂ
鬓	镸彡八Ｂ
剖	立口刂Ｐ
蜿	虫宀Ｗ
鞍	革宀女Ａ
伫	亻宀一Ｚ
恤	忄丿皿Ｘ
铿	钅又土Ｋ
鸳	夕鸟Ｙ
蝗	虫白王Ｈ
茸	艹耳ＲＧ
赃	贝广土Ｚ
谴	讠<贵上>辶Ｑ
邑	口巴ＹＩ
俐	亻禾刂Ｌ
吮	口厶儿Ｓ
刊	干刂ＫＮ
钳	钅廿一Ｑ
亥	亥ＨＩ丶
噎	口士<首上>Ｙ
巩	工几丶Ｇ
驹	马勹口Ｊ
薰	艹千黑Ｘ
踌	<丰变>寸Ｃ
饕	口虍食Ｔ
矗	十<具上><具上>Ｃ
躇	艹者Ｃ
蹑	耳又Ｎ
弑	乂朩弋Ｓ
崭	山<车旁>斤Ｚ
褚	衤者ＣＵ
湮	氵覀土Ｙ
踞	尸古Ｊ
恺	忄山己Ｋ
鸠	九鸟ＪＵ
邯	廿一阝Ｈ
渍	氵贝Ｚ
汴	氵亠卜Ｂ
蜈	虫口大Ｗ
惦	忄广占Ｄ
谑	讠虍<虐下>Ｘ
砌	石七刀Ｑ
辎	<车旁>巛田Ｚ
贿	贝冃Ｈ
癫	疒十页Ｄ
诫	讠戈廾Ｊ
赘	敖贝ＺＩ
伎	亻十又Ｊ
铐	钅耂丂Ｋ
诣	讠匕日Ｙ
匡	匚王ＫＧ
岌	山及ＪＩ
旎	<旗角>尸匕Ｎ
锈	钅禾乃Ｘ
桅	木Ｗ
鸯	央鸟ＹＧ
鲲	鱼日比Ｋ
莞	艹宀元Ｇ
玮	王二<韦下>Ｗ
剌	木口刂Ｌ
茱	艹朱ＺＵ
祁	礻阝ＱＩ
奠	酋大ＤＮ
岱	代山ＤＩ
辫	<辛变>纟辛Ｂ
闵	门文ＭＮ
燎	火大小Ｌ
椒	木<卓上>又Ｊ
缇	纟日<足下>Ｔ
惴	忄山<而下>Ｚ
疮	疒人Ｃ
酌	酉勹丶Ｚ
窖	穴口Ｊ
邬	乌阝ＷＵ
呦	口幺力Ｙ
顼	王页ＸＵ
岐	山十又Ｑ
捋	扌爫寸Ｌ
飕	风叟ＳＵ
楮	木者ＣＵ
帷	巾隹ＷＩ
笃	马ＤＵ
噔	口癶<首上>Ｄ
骰	骨殳ＴＵ
鄂	吅<亏下>阝Ｅ
珏	王王丶Ｊ
汩	氵曰ＧＵ
鑫	金金金Ｘ
嘤	口贝女Ｙ
掰	八手Ｂ
峦	<变上>山ＬＮ
冢	冖豕丶Ｚ
瓮	八厶瓦Ｗ
唏	口乂巾Ｘ
蟆	虫莫ＭＡ
掣	牛刂手Ｃ
隘	阝<首上>皿Ａ
瞩	目尸冂Ｚ
茗	艹夕口Ｍ
哝	口<巾变><辰下>Ｎ
拷	扌耂丂Ｋ
蚣	虫八厶Ｇ
慵	忄广冃Ｙ
洼	氵圭ＷＡ
牟	厶牛ＭＵ
娄	米女ＬＵ
敝	丷巾攵Ｂ
孜	子攵ＺＩ
龌	止凵土Ｗ
餮	歹人食Ｔ
窦	穴十头Ｄ
烘	火八Ｈ
咣	口儿Ｇ
飒	立风ＳＡ
咎	夂卜口Ｊ
憧	忄立里Ｃ
逵	土八辶Ｋ
闽	门虫ＭＮ
啷	口丶阝Ｌ
睨	目臼儿Ｎ
铅	钅几口Ｑ
楷	木比白Ｋ
绎	纟又<举下>Ｙ
皎	白亠父Ｊ
龊	止凵足Ｃ
阉	门大日Ｙ
黠	黑吉ＸＡ
隼	隹十ＳＮ
菌	艹囗禾Ｊ
钗	钅又丶Ｃ
诶	讠厶矢Ｅ
杠	木工ＧＧ
靥	厂大罒Ｙ
饲	饣一Ｓ
蜃	厂<辰内>虫Ｓ
筛	<归左>巾Ｓ
淼	水水水Ｍ
粪	米八Ｆ
颍	匕水页Ｙ
喏	口艹口Ｎ
苔	艹厶口Ｔ
啬	十<首上>囗Ｓ
闸	门甲ＺＡ
憬	忄日小Ｊ
伢	亻一<牙下>Ｙ
酝	酉云ＹＮ
柬	木<黑上>ＪＮ
啄	口豕丶Ｚ
窑	穴缶ＹＯ
旖	<旗角>大可Ｙ
喵	口艹田Ｍ
寰	宀罒<衣下>Ｈ
羔	灬ＧＯ
膳	月羊口Ｓ
缅	纟丆罒Ｍ
垣	土一一Ｙ
筠	土勹Ｊ
乒	丘丿ＰＧ
榨	木穴乍Ｚ
笈	及ＪＩ
瞑	目冖八Ｍ
剁	几木刂Ｄ
奚	爫幺大Ｘ
兖	亠八儿Ｙ
庵	广大乚Ａ
瓒	王贝Ｚ
孺	子<雨头><而下>Ｒ
梓	木辛ＺＩ
杵	木午ＣＵ
扉	户非ＦＩ
诲	讠母Ｈ
坍	土<周框>亠Ｔ
咂	口匚巾Ｚ
噤	口林示Ｊ
峥	山亅Ｚ
纶	纟人匕Ｌ
壑	<卓上>又土Ｈ
殉	歹勹日Ｘ
辐	<车旁>畐ＦＵ
蜕	虫丷儿Ｔ
唆	口厶夂Ｓ
阖	门土厶Ｈ
谛	讠<旁上>巾Ｄ
穗	禾士心Ｓ
琶	王王巴Ｐ
螳	虫土Ｔ
盎	央皿ＡＧ
褒	亠亻<衣下>Ｂ
贲	十艹贝Ｂ
毋	毋ＷＵ乛
淬	氵亠十Ｃ
藻	<艹氵>氵木Ｚ
粟	覀米ＳＵ
袜	衤末ＷＡ
佟	亻夂<冬下>Ｔ
簸	其皮Ｂ
苇	艹二<韦下>Ｗ
醇	酉<享上>子Ｃ
枣	木冂<冬下>Ｚ
拗	扌幺力Ａ
椎	木隹ＺＩ
橡	木象ＸＧ
蹋	日羽Ｔ
遐	<右框><右框>辶Ｘ
拌	扌半ＢＮ
馋	饣<冬下>Ｃ
橘	木冂Ｊ
霭	<雨头>讠勹Ａ
啜	口又又Ｃ
撮	扌日又Ｃ
馒	饣日又Ｍ
纬	纟二<韦下>Ｗ
嬴	<赢框>女ＹＧ
潺	氵尸子Ｃ
筏	亻戈Ｆ
宦	宀匚丨Ｈ
娑	氵少女Ｓ
鹭	各鸟Ｌ
玎	王丁ＤＧ
抉	扌夬ＪＥ
匍	勹甫ＰＵ
蕃	艹丿田Ｆ
恻	忄贝刂Ｃ
乓	丘丶ＰＧ
苞	艹勹巳Ｂ
胥	乛<足下>冃Ｘ
帛	白巾ＢＯ
驮	马大ＴＯ
痪	疒大Ｈ
碾	石尸<辰下>Ｎ
陕	阝夫丷Ｓ
嬷	女广厶Ｍ
髯	镸彡土Ｒ
嫦	女巾Ｃ
耷	大耳ＤＡ
阑	门木<黑上>Ｌ
迳	<经角>工辶Ｊ
弈	亠<赤下>廾Ｙ
眦	目止匕Ｚ
侬	亻<巾变><辰下>Ｎ
娓	女尸毛Ｗ
噘	口厂欠Ｊ
炬	火匚<右框>Ｊ
沥	氵厂力Ｌ
曜	日羽隹Ｙ
禧	礻吉口Ｘ
陇	阝龙ＬＧ
咛	口宀丁Ｎ
砾	石<卬左>小Ｌ
竺	二ＺＵ
胭	月囗大Ｙ
涧	氵门日Ｊ
墩	土<享上>攵Ｄ
呲	口止匕Ｃ
篡	目厶Ｃ
昙	日云ＴＮ
蟠	虫丿田Ｐ
旌	<旗角>丿Ｊ
睦	目土土Ｍ
羹	灬大Ｇ
琵	王王比Ｐ
咀	口且ＪＵ
馅	饣臼Ｘ
讷	讠内ＮＥ
磷	石米<舛右>Ｌ
孵	<卯左>爫子Ｆ
濒	氵止页Ｂ
亘	一日一Ｇ
簧	八Ｈ
诬	讠工从Ｗ
擞	扌米攵Ｓ
魃	白<见下>犮Ｂ
瓯	匚乂瓦Ｏ
曝	日日氺Ｐ
删	册刂ＳＮ
徨	彳白王Ｈ
宓	宀心丿Ｍ
桨	丬夕木Ｊ
楣	木<声下>目Ｍ
铎	钅又<举下>Ｄ
剐	口内刂Ｇ
匐	勹畐ＦＵ
腆	月冂八Ｔ
谏	讠木<黑上>Ｊ
粼	米夕<粼右>Ｌ
阐	门丷日Ｃ
婀	女阝可Ｅ
邺	业阝ＹＥ
纨	纟九丶Ｗ
辗	<车旁>尸<辰下>Ｚ
卉	十廾ＨＩ
偃	亻匚日Ｙ
鹊	日鸟Ｑ
槛	木<半竹>皿Ｊ
荼	艹亼朩Ｔ
锭	钅宀<足下>Ｄ
瘴	疒音十Ｚ
瑙	王巛<囱框>Ｎ
皂	白七ＺＯ
踝	日木Ｈ
铳	钅<充上>儿Ｃ
锄	钅且力Ｃ
剃	丷丿刂Ｔ
吠	口大丶Ｆ
蛰	执虫ＺＥ
琰	王火火Ｙ
叟	叟ＳＵ丿
缤	纟穴丘Ｂ
颌	亼口页Ｈ
珈	王加ＪＡ
浏	氵文刂Ｌ
卤	<卓上>囗乂Ｌ
匾	匚户冊Ｂ
飚	风火火Ｂ
刨	勹巳刂Ｐ
杞	木己ＱＩ
馁	饣爫女Ｎ
瘸	疒加内Ｑ
榭	木身寸Ｘ
绛	纟夂<舛右>Ｊ
姒	女以ＳＩ
殒	歹口贝Ｙ
瓢	覀示瓜Ｐ
窈	穴幺力Ｙ
栓	木人王Ｓ
婊	女<衣下>Ｂ
譬	尸辛言Ｐ
谄	讠臼Ｃ
垠	土艮ＹＮ
壹	士冖<首上>Ｙ
呤	口今丶Ｌ
烹	<享上>乛灬Ｐ
靳	革斤ＪＮ
丕	不一ＰＩ
蕉	艹隹灬Ｑ
隅	阝甲冂Ｙ
礴	石<艹氵>寸Ｂ
嫖	女覀示Ｐ
炊	火欠ＣＩ
珞	王各ＬＯ
挲	氵少手Ｓ
蛾	虫手戈Ｅ
膺	广亻冃Ｙ
猬	犭田冃Ｗ
潞	氵各Ｌ
筐	匚王Ｋ
骜	敖马ＡＯ
俑	亻<甬下>Ｙ
鳌	敖鱼ＡＯ
稣	鱼禾ＳＵ
蒜	艹示示Ｓ
窕	穴<兆左><兆右>Ｔ
腋	月亠夂Ｙ
魑	白<见下>文Ｃ
芮	艹内ＲＩ
簪	旡日Ｚ
麴	木夂勹Ｑ
黔	黑今ＱＮ
垢	土<后上>口Ｇ
屉	尸世ＴＩ
馀	饣亼朩Ｙ
笋	<秉中>丿Ｓ
轼	<车旁>弋工Ｓ
汲	氵及ＪＩ
迥	冂口辶Ｊ
垄	龙土ＬＧ
弼	弓丆弓Ｂ
沣	氵丰ＦＧ
稼	禾宀豕Ｊ
纣	纟寸ＺＵ
郢	口王阝Ｙ
藐	艹豸儿Ｍ
寅	穴一由Ｙ
戍	戊丶ＳＵ
簿	氵寸Ｂ
拄	扌主ＺＵ
泌	氵心丿Ｍ
渲	氵宀一Ｘ
嚏	口十<足下>Ｔ
呓	口艹乙Ｙ
篆	彑<豕下>Ｚ
斓	文门木Ｌ
鲤	鱼里ＬＩ
熹	吉<首上>灬Ｘ
圭	圭ＧＩ一
锏	钅门日Ｊ
螃	虫<旁上>方Ｐ
茎	艹<经角>工Ｊ
龇	止凵匕Ｚ
丙	一内ＢＧ
皑	白山己Ａ
睚	目厂圭Ｙ
撂	扌田各Ｌ
惆	忄<周框>土Ｃ
鸥	匚乂鸟Ｏ
嚅	口<雨头><而下>Ｒ
炳	火一内Ｂ
谧	讠心皿Ｍ
篱	文冂Ｌ
跚	册ＳＮ
渤	氵十力Ｂ
螓	虫禾Ｑ
矶	石几ＪＩ
梗	木一乂Ｇ
岑	山今ＣＮ
槌	木<阜上>辶Ｃ
糗	米自大Ｑ
滤	氵虍心Ｌ
蛆	虫且ＱＵ
拴	扌人王Ｓ
晁	日<兆左><兆右>Ｃ
犷	犭广ＧＧ
潼	氵立里Ｔ
灶	火土ＺＯ
踵	千里Ｚ
坝	土贝ＢＡ
髻	镸彡吉Ｊ
嗲	口父夕Ｄ
袒	衤日一Ｔ
晔	日<化右>十Ｙ
碳	石山火Ｔ
麓	林<鹿上>比Ｌ
渝	氵亼<前下>Ｙ
涔	氵山乛Ｃ
卯	<卯左>卩ＭＯ
菡	艹乛凵Ｈ
泯	氵巳七Ｍ
撬	扌毛毛Ｑ
羚	今丶Ｌ
抠	扌匚乂Ｋ
嗬	口艹可Ｈ
馈	饣<贵上>贝Ｋ
骠	马覀示Ｂ
凋	冫<周框>土Ｄ
赂	贝各ＬＵ
噌	口丷日Ｃ
鸨	匕十鸟Ｂ
苜	艹目ＭＵ
幌	巾日儿Ｈ
褥	衤厂寸Ｒ
嘹	口大小Ｌ
袂	衤夬ＭＩ
荤	艹冖车Ｈ
囤	囗七凵Ｄ
裆	衤彐Ｄ
盅	中皿ＺＧ
醺	酉千黑Ｘ
萃	艹亠十Ｃ
赧	土<赤下>又Ｎ
婵	女丷十Ｃ
氤	气囗大Ｙ
腼	月丆罒Ｍ
梆	木<丰变>阝Ｂ
涸	氵囗古Ｈ
釜	父干<首上>Ｆ
镭	钅<雨头>田Ｌ
椭	木冃Ｔ
祠	礻一Ｃ
硫	石<充上><流角>Ｌ
晤	日五口Ｗ
隗	阝白<见下>Ｋ
痉	疒<经角>工Ｊ
笺	一戈Ｊ
饺	饣亠父Ｊ
睐	目未丷Ｌ
峒	山冂一Ｄ
涤	氵夂朩Ｄ
俸	亻<举下>Ｆ
玟	王文ＷＮ
谪	讠<商外>古Ｚ
渥	氵尸至Ｗ
劾	亥力ＨＥ
氲	气日皿Ｙ
挛	<变上>手ＬＮ
蹒	艹两Ｐ
霈	<雨头>氵巾Ｐ
舫	舟方ＦＧ
鳅	鱼禾火Ｑ
苋	艹见ＸＮ
琬	王宀Ｗ
怏	忄央ＹＧ
嗫	口耳又Ｎ
瞰	目乛攵Ｋ
蚌	虫丰ＢＧ
溯	氵<首上>月Ｓ
沓	水日ＴＡ
翌	羽立ＹＩ
蜻	虫月Ｑ
甭	不用ＢＧ
唷	口<充上>冃Ｙ
藕	艹耒冂Ｏ
疵	疒止匕Ｃ
啾	口禾火Ｊ
绔	纟大<亏下>Ｋ
毓	母<流角>Ｙ
桉	木宀女Ａ
癖	疒尸辛Ｐ
蝼	虫米女Ｌ
韶	音刀口Ｓ
霁	<雨头>文<齐下>Ｊ
蔬	艹止<流角>Ｓ
跤	亠父Ｊ
甥	丿力Ｓ
颐	匚丨页Ｙ
怂	从心ＳＧ
炕	火亠几Ｋ
咿	口<秉中>丿Ｙ
咤	口宀七Ｚ
毡	毛占ＺＮ
桔	木吉ＪＥ
鳖	丷攵鱼Ｂ
弋	弋ＹＩ一
撰	扌巳八Ｚ
晾	日<享上>小Ｌ
泞	氵宀丁Ｎ
嗝	口一冂Ｇ
霾	<雨头>豸里Ｍ
蟑	虫音十Ｚ
臌	月十又Ｇ
掬	扌勹米Ｊ
绾	纟宀<官下>Ｗ
獒	敖大丶Ａ
璞	王业丶Ｐ
臊	月口木Ｓ
臾	臼人ＹＵ
恸	忄云力Ｔ
贮	贝宀一Ｚ
阂	门亥ＨＥ
岖	山匚乂Ｑ
翟	羽隹ＤＩ
咨	冫欠口Ｚ
堑	<车旁>斤土Ｑ
倡	亻日日Ｃ
忏	忄千ＣＮ
妤	女<予下>Ｙ
啵	口氵皮Ｂ
殛	歹乛一Ｊ
瞌	目土皿Ｋ
哐	口匚王Ｋ
圃	囗甫ＰＵ
蛹	虫<甬下>Ｙ
俭	亻亼<应下>Ｊ
灸	丶火Ｊ
剽	覀示刂Ｐ
缆	纟<半竹>见Ｌ
橱	木厂寸Ｃ
秤	禾干丷Ｃ
搪	扌广口Ｔ
嗥	口白十Ｈ
粲	<卓上>又米Ｃ
钛	钅大丶Ｔ
圳	土川ＺＮ
邕	巛口巴Ｙ
畿	幺戈田Ｊ
鹦	贝女鸟Ｙ
淀	氵宀<足下>Ｄ
褂	衤圭卜Ｇ
瘤	疒<卬左>田Ｌ
忤	忄午ＷＵ
笠	立ＬＩ
挎	扌大<亏下>Ｋ
渭	氵田冃Ｗ
糯	米<雨头><而下>Ｎ
祗	礻<卬左>七Ｚ
肾	<临左>又冃Ｓ
恿	<甬下>心Ｙ
垛	土几木Ｄ
鹉	一止鸟Ｗ
纺	纟方ＦＧ
觎	亼<前下>见Ｙ
觊	山己见Ｊ
潋	氵亼攵Ｌ
猊	犭臼儿Ｎ
豺	豸才ＣＩ
胚	月不一Ｐ
魍	白<见下>冂Ｗ
琛	王木Ｃ
炜	火二<韦下>Ｗ
揶	扌耳阝Ｙ
鬃	镸彡示Ｚ
汜	氵巳ＳＩ
辘	<车旁><鹿上>比Ｌ
雹	<雨头>勹巳Ｂ
玷	王占ＤＮ
撵	扌夫车Ｎ
颦	止页卑Ｐ
坳	土幺力Ａ
杳	木日ＹＯ
荃	艹人王Ｑ
揄	扌亼<前下>Ｙ
摁	扌囗心Ｅ
咝	口<乡上>一Ｓ
辄	<车旁>耳乚Ｚ
箩	罒夕Ｌ
鹞	爫缶鸟Ｙ
犸	犭马ＭＡ
捎	扌冃Ｓ
潦	氵大小Ｌ
蚯	虫丘ＱＵ
翊	立羽ＹＩ
湄	氵<声下>目Ｍ
芋	艹于ＹＵ
靼	革日一Ｄ
濑	氵木贝Ｌ
郸	丷十阝Ｄ
啕	口勹缶Ｔ
粱	氵刀米Ｌ
镀	钅广又Ｄ
汐	氵夕ＸＩ
榆	木亼<前下>Ｙ
淇	氵其ＱＩ
魉	白<见下>两Ｌ
脓	月<巾变><辰下>Ｎ
苯	艹木一Ｂ
赈	贝厂<辰内>Ｚ
觐	廿见Ｊ
坷	土可ＫＥ
篑	<贵上>贝Ｋ
哂	口西ＳＮ
旃	<旗角><周框>亠Ｚ
齑	文非<齐下>Ｊ
荦	艹冖牛Ｌ
裟	氵少<衣下>Ｓ
辇	夫夫车Ｎ
幔	巾日又Ｍ
蘅	艹彳亍Ｈ
颚	吅<亏下>页Ｅ
犄	牜大可Ｊ
惰	忄冃Ｄ
徙	彳止<足下>Ｘ
蚓	虫弓丨Ｙ
柿	木亠巾Ｓ
睥	目卑ＰＩ
讹	讠亻<化右>Ｅ
嵘	山艹木Ｒ
嗵	口辶Ｔ
暹	日隹辶Ｘ
悼	忄<卓上>十Ｄ
罔	冂<首上>亡Ｗ
琏	王车辶Ｌ
蠡	彑虫虫Ｌ
囵	囗人匕Ｌ
骊	马一冂Ｌ
堰	土匚日Ｙ
趄	走且ＪＵ
宸	宀厂<辰内>Ｃ
垦	艮土ＫＮ
啻	<旁上>巾口Ｃ
趔	走歹刂Ｌ
魈	白<见下>Ｘ
麝	<鹿上>比寸Ｓ
摒	扌尸开Ｂ
遢	日羽辶Ｔ
癌	疒口山Ａ
漳	氵音十Ｚ
瑁	王<冒上>目Ｍ
硅	石圭ＧＩ
斡	十十斗Ｗ
锚	钅艹田Ｍ
玳	王代ＤＩ
耙	耒巴ＢＡ
沽	氵古ＧＵ
颉	吉页ＪＥ
湍	氵山<而下>Ｔ
袤	亠<衣下>Ｍ
卞	亠卜ＢＮ
纰	纟比ＰＩ
壬	壬ＲＮ丿
褶	衤羽白Ｚ
袄	衤丿大Ａ
肇	户攵<举下>Ｚ
犁	禾刂牛Ｌ
鼾	自丌干Ｈ
邋	巛囗辶Ｌ
忻	忄斤ＸＮ
淅	氵木斤Ｘ
侨	亻丿<齐下>Ｑ
诽	讠非ＦＩ
孪	<变上>子ＬＮ
倨	亻尸古Ｊ
脐	月文<齐下>Ｑ
皿	皿ＭＮ丨
阗	门十<具上>Ｔ
嘣	口山月Ｂ
螭	虫文冂Ｃ
腴	月臼人Ｙ
骡	马田小Ｌ
恣	冫欠心Ｚ
瘠	疒<脊左>月Ｊ
噶	口艹勹Ｇ
掸	扌丷十Ｄ
谙	讠音ＡＮ
愠	忄日皿Ｙ
谲	讠冂Ｊ
叵	匚口ＰＯ
痰	疒火火Ｔ
薯	艹罒者Ｓ
袈	加亠<衣下>Ｊ
淄	氵巛田Ｚ
彗	丰丰彐Ｈ
恪	忄各ＫＥ
孱	尸子子Ｃ
迄	乙辶Ｑ
蔫	艹<亏下>灬Ｎ
蜗	虫口内Ｗ
癞	疒木贝Ｌ
遑	白王辶Ｈ
噫	口音ＹＩ
羯	日勹Ｊ
鲛	鱼亠父Ｊ
涓	氵口冃Ｊ
罂	贝贝缶Ｙ
褛	衤米女Ｌ
揩	扌比白Ｋ
嫔	女穴丘Ｐ
褴	衤<半竹>皿Ｌ
郦	一冂阝Ｌ
潢	氵八Ｈ
镑	钅<旁上>方Ｂ
馥	禾日夂Ｆ
炖	火七凵Ｄ
镣	钅大小Ｌ
瘁	疒亠十Ｃ
桧	木人云Ｇ
讧	讠工ＨＧ
迩	小辶Ｅ
涮	氵尸刂Ｓ
澹	氵言Ｔ
嶙	山米<舛右>Ｌ
徵	<微框>王ＺＧ
蔻	艹宀元Ｋ
豚	月豕ＴＮ
镂	钅米女Ｌ
轲	<车旁>可ＫＥ
篓	米女Ｌ
禺	甲冂一Ｙ
樵	木隹灬Ｑ
遽	虍豕辶Ｊ
怵	忄木丶Ｃ
孬	不女子Ｎ
臃	月亠隹Ｙ
芹	艹斤ＱＮ
挞	扌大辶Ｔ
偕	亻比白Ｘ
酆	丰<首上>阝Ｆ
臼	臼ＪＵ丿
贽	执贝ＺＩ
碉	石<周框>土Ｄ
蒯	艹月刂Ｋ
夙	<风上>歹ＳＵ
煊	火宀一Ｘ
蓁	艹禾Ｚ
掖	扌亠夂Ｙ
帚	彐冖巾Ｚ
泠	氵今丶Ｌ
臆	月音心Ｙ
粤	<囱框>米丂Ｙ
銮	<变上>金ＬＮ
抒	扌<予下>Ｓ
偻	亻米女Ｌ
庖	广勹巳Ｐ
椰	木耳阝Ｙ
琮	王宀示Ｃ
匮	匚<贵上>贝Ｋ
峋	山勹日Ｘ
榄	木<半竹>见Ｌ
盹	目七凵Ｄ
轧	<车旁>乚ＺＡ
诋	讠<卬左>七Ｄ
夥	日木夕Ｈ
憩	舌自心Ｑ
戛	丆目戈Ｊ
瞿	目目隹Ｑ
佻	亻<兆左><兆右>Ｔ
遨	敖辶ＡＯ
阜	<阜上>十ＦＵ
镳	钅<鹿上>灬Ｂ
蜓	虫壬廴Ｔ
鏖	<鹿上>比金Ａ
摞	扌田小Ｌ
忪	忄八厶Ｓ
噙	口人冂Ｑ
夔	<首上>丿夂Ｋ
仞	亻刀丶Ｒ
荑	艹大弓Ｙ
鸢	弋鸟ＹＮ
洱	氵耳ＥＲ
姣	女亠父Ｊ
腺	月白水Ｘ
泱	氵央ＹＧ
捱	扌厂圭Ａ
跆	厶口Ｔ
闾	门口口Ｌ
犒	牜<高外>口Ｋ
琊	王一阝Ｙ
盂	于皿ＹＵ
骥	马匕八Ｊ
岷	山巳七Ｍ
鸶	<乡上><乡上>鸟Ｓ
痣	疒士心Ｚ
闳	门厶Ｈ
帼	巾囗王Ｇ
碴	石木一Ｃ
芍	艹勹丶Ｓ
犊	牜十头Ｄ
蝈	虫囗王Ｇ
粽	米宀示Ｚ
侗	亻冂一Ｄ
喟	口田冃Ｋ
傥	亻儿Ｔ
卟	口卜ＢＵ
蓟	艹鱼刂Ｊ
馊	饣叟ＳＵ
堇	廿口Ｊ
踮	广占Ｄ
冗	冖几ＲＧ
倜	亻<周框>土Ｔ
蹩	丷攵足Ｂ
珩	王彳亍Ｈ
奂	冂大Ｈ
戌	戊一ＸＵ
鄢	一灬阝Ｙ
濡	氵<雨头><而下>Ｒ
谀	讠臼人Ｙ
镐	钅<高外>口Ｇ
僖	亻吉口Ｘ
幄	巾尸至Ｗ
狒	犭弓<齐下>Ｆ
颛	山<而下>页Ｚ
鹧	广廿鸟Ｚ
箕	其ＪＩ
翦	<首上><前下>羽Ｊ
摹	莫手ＭＯ
愫	忄小Ｓ
椁	木<享上>子Ｇ
倌	亻宀<官下>Ｇ
佝	亻勹口Ｇ
萼	艹吅<亏下>Ｅ
骧	马亠<衣下>Ｘ
锹	钅禾火Ｑ
娼	女日日Ｃ
燮	火火又Ｘ
弭	弓耳ＭＩ
诌	讠彐Ｚ
泗	氵囗儿Ｓ
鸪	古鸟ＧＵ
洵	氵勹日Ｘ
雉	矢隹ＺＩ
漕	氵<曹上>日Ｃ
怩	忄尸匕Ｎ
猷	酋大丶Ｙ
贰	弋二贝Ｅ
汶	氵文ＷＮ
淆	氵乂冃Ｘ
赣	音夂贝Ｇ
钊	钅刂ＺＯ
轶	<车旁>失ＹＩ
鳍	鱼耂日Ｑ
忸	忄丑ＮＵ
喙	口彑<豕下>Ｈ
筵	丿廴Ｙ
橇	木毛毛Ｑ
箬	口Ｑ
祚	礻乍ＺＯ
燧	火<首上>辶Ｓ
沂	氵斤ＹＩ
繇	爫缶小Ｙ
蕙	艹士心Ｈ
濠	氵<亮上>豕Ｈ
沅	氵元ＹＮ
莆	艹甫ＰＵ
砺	石厂Ｌ
槟	木穴丘Ｂ
骛	攵马Ｗ
刽	人云刂Ｇ
獗	犭厂欠Ｊ
睑	目亼<应下>Ｊ
岈	山一<牙下>Ｙ
牒	片世木Ｄ
艮	艮ＧＮ乛
荥	艹冖水Ｘ
妪	女匚乂Ｙ
诠	讠人王Ｑ
悖	忄十子Ｂ
唳	口户大Ｌ
纾	纟<予下>Ｓ
浃	氵夫丷Ｊ
狻	犭厶夂Ｓ
蚱	虫乍ＺＡ
钏	钅川ＣＮ
搡	扌又木Ｓ
浣	氵宀元Ｈ
谗	讠<冬下>Ｃ
麋	<鹿上>比米Ｍ
钺	钅戈乚Ｙ
宕	宀石ＤＧ
鹄	口鸟Ｈ
砥	石<卬左>七Ｄ
杈	木又丶Ｃ
呷	口甲ＸＡ
撸	扌鱼日Ｌ
邈	豸白辶Ｍ
膘	月覀示Ｂ
橄	木乛攵Ｇ
滟	氵巴Ｙ
俪	亻一冂Ｌ
谤	讠<旁上>方Ｂ
鸩	<巾变>乚鸟Ｚ
怆	忄人Ｃ
忾	忄气ＫＩ
邝	广阝ＫＧ
缮	纟羊口Ｓ
汾	氵八刀Ｆ
绉	纟彐Ｚ
攫	扌目又Ｊ
畸	田大可Ｊ
磬	士殳石Ｑ
蹇	宀<冓上>足Ｊ
钠	钅内ＮＡ
贻	贝厶口Ｙ
舀	爫臼ＹＯ
恁	亻壬心Ｎ
箐	月Ｑ
腓	月非ＦＩ
铝	钅口口Ｌ
赳	走丩ＪＵ
沏	氵七刀Ｑ
氢	气<经角>工Ｑ
檄	木白攵Ｘ
坂	土又Ｂ
炷	火主ＺＵ
垩	亚土ＥＥ
隽	隹乃ＪＮ
驽	女又马Ｎ
陲	阝千<垂下>Ｃ
泾	氵<经角>工Ｊ
蹶	厂欠Ｊ
哺	口甫ＢＵ
磺	石八Ｈ
匝	匚巾ＺＡ
讼	讠八厶Ｓ
掇	扌又又Ｄ
霰	<雨头>冃攵Ｘ
哔	口比十Ｂ
坯	土不一Ｐ
蘸	艹酉灬Ｚ
嫒	女<爱上>又Ａ
苓	艹今丶Ｌ
遛	<卬左>刀辶Ｌ
皋	白大十Ｇ
僮	亻立里Ｚ
跖	石ＺＩ
佞	亻二女Ｎ
衩	衤又丶Ｃ
鳗	鱼日又Ｍ
涿	氵豕丶Ｚ
翳	匚殳羽Ｙ
糠	米广水Ｋ
彝	彑米廾Ｙ
荔	艹力力Ｌ
髦	镸彡毛Ｍ
佶	亻吉ＪＩ
娣	女丷弓Ｄ
胛	月甲ＪＡ
铄	钅<卬左>小Ｓ
诘	讠吉ＪＩ
濮	氵业丶Ｐ
浒	氵讠午Ｈ
敕	木口攵Ｃ
逅	<后上>口辶Ｈ
姹	女宀七Ｃ
迤	也辶Ｙ
巽	巳巳八Ｘ
钜	钅匚<右框>Ｊ
嗑	口土皿Ｋ
舶	舟白ＢＯ
仨	亻三ＳＡ
翕	亼口羽Ｘ
厩	厂<即左>旡Ｊ
莓	艹母Ｍ
颀	斤页ＱＩ
锺	钅千里Ｚ
阚	门乛耳Ｈ
舄	臼勹灬Ｘ
孚	爫子ＦＵ
呶	口女又Ｎ
呔	口大丶Ｄ
蜍	虫亼朩Ｃ
貉	豸各ＨＥ
莜	艹亻攵Ｙ
藜	艹禾氺Ｌ
肪	月方ＦＧ
膻	月亠一Ｓ
刎	勹<两撇>刂Ｗ
氅	攵毛Ｃ
聃	耳冂土Ｄ
泸	氵<卓上>尸Ｌ
阪	阝又Ｂ
懑	氵艹心Ｍ
猡	犭罒夕Ｌ
圜	囗罒一Ｈ
儆	亻艹攵Ｊ
逖	犭火辶Ｔ
聒	耳舌ＧＯ
邙	亡阝ＭＧ
秣	禾末ＭＯ
汕	氵山ＳＮ
扪	扌门ＭＮ
谒	讠日勹Ｙ
衾	今亠<衣下>Ｑ
龅	止凵勹Ｂ
戗	人戈Ｑ
姝	女朱ＳＵ
昶	丶<永下>日Ｃ
埔	土甫ＰＵ
罄	士殳缶Ｑ
蛀	虫主ＺＵ
嗳	口<爱上>又Ａ
绶	纟<爱上>又Ｓ
汨	氵日ＭＩ
谩	讠日又Ｍ
螟	虫冖八Ｍ
佥	亼<应下>ＱＮ
邂	刀辶Ｘ
竣	立厶夂Ｊ
耘	耒云ＹＮ
俾	亻卑ＢＩ
沱	氵宀匕Ｔ
蜚	非虫ＦＩ
湫	氵禾火Ｑ
焊	火日干Ｈ
砝	石土厶Ｆ
舐	舌<卬左>七Ｓ
赝	厂亻贝Ｙ
恹	忄厂大Ｙ
蛭	虫至ＺＩ
滇	氵十八Ｄ
剜	宀夕刂Ｗ
昀	日勹冫Ｙ
缙	纟亚日Ｊ
鸵	鸟宀匕Ｔ
樽	木酋寸Ｚ
俟	亻厶矢Ｑ
谆	讠<享上>子Ｚ
裨	衤卑ＢＩ
蒺	艹疒矢Ｊ
涪	氵立口Ｆ
葩	艹白巴Ｐ
诃	讠可ＨＥ
鞅	革央ＹＧ
踊	<甬下>Ｙ
氐	<卬左>七丶Ｄ
荏	艹亻壬Ｒ
淙	氵宀示Ｃ
蹴	尢丶Ｃ
藓	艹鱼羊Ｘ
煅	火<段左>殳Ｄ
谡	讠田夂Ｓ
猕	犭小Ｍ
浚	氵厶夂Ｊ
淞	氵八厶Ｓ
瘌	疒木刂Ｌ
潸	氵林冃Ｓ
跛	皮ＢＯ
桢	木<卓上>贝Ｚ
坨	土宀匕Ｔ
俦	亻<丰变>寸Ｃ
楔	木刀大Ｘ
铤	钅壬廴Ｔ
犟	弓口牛Ｊ
矍	目目又Ｊ
菠	<艹氵>皮ＢＯ
诮	讠冃Ｑ
笆	巴ＢＡ
崧	山木厶Ｓ
绥	纟爫女Ｓ
獐	犭音十Ｚ
溥	氵甫寸Ｐ
恫	忄冂一Ｄ
饪	饣壬ＲＮ
殄	歹人彡Ｔ
昴	日<卯左>卩Ｍ
槿	木廿Ｊ
牦	牜毛ＭＯ
馍	饣莫ＭＯ
砧	石占ＺＮ
葳	艹戊一Ｗ
滂	氵<旁上>方Ｐ
绡	纟冃Ｘ
鎏	氵<充上>金Ｌ
骓	马隹ＺＩ
醐	酉古月Ｈ
囱	<囱框>夂ＣＧ
噱	口虍豕Ｊ
黜	黑凵山Ｃ
哓	口<尧上>儿Ｘ
祛	礻土厶Ｑ
抨	扌干丷Ｐ
绺	纟卜口Ｌ
咩	口羊ＭＥ
醍	酉日<足下>Ｔ
戊	戊ＷＵ一
茁	艹凵山Ｚ
佃	亻田ＤＮ
蚤	又丶虫Ｚ
塾	<享上>九土Ｓ
谟	讠莫ＭＯ
釉	丿米由Ｙ
谚	讠立彡Ｙ
诰	讠口Ｇ
锟	钅日比Ｋ
灞	氵<雨头>月Ｂ
町	田丁ＤＧ
嗄	口丆夂Ａ
逡	厶八辶Ｑ
葭	艹丨又Ｊ
柩	木匚Ｊ
滓	氵宀辛Ｚ
跻	文<齐下>Ｊ
棂	木彐火Ｌ
诳	讠犭王Ｋ
籽	米子ＺＩ
囫	囗勹<两撇>Ｈ
锷	钅吅<亏下>Ｅ
碱	石戊一Ｊ
奘	爿士大Ｚ
獬	犭刀牛Ｘ
夯	大力ＨＧ
痿	疒禾女Ｗ
痍	疒大弓Ｙ
秧	禾央ＹＧ
榷	木冖隹Ｑ
忱	忄<巾变>乚Ｃ
鱿	鱼尢丶Ｙ
圉	囗土<首上>Ｙ
峪	山八<谷下>Ｙ
绌	纟凵山Ｃ
馗	九<首上>自Ｋ
酉	酉ＹＵ一
莒	艹口口Ｊ
嶂	山音十Ｚ
酡	酉宀匕Ｔ
崴	山戊一Ｗ
镌	钅隹乃Ｊ
殁	歹殳ＭＯ
膑	月穴丘Ｂ
徇	彳勹日Ｘ
纭	纟云ＹＮ
脶	月口内Ｌ
鹘	骨鸟ＧＵ
腌	月大乚Ａ
叁	厶大三Ｓ
碇	石宀<足下>Ｄ
晷	日夂口Ｇ
兕	凹儿ＳＩ
渚	氵者ＺＵ
刍	彐ＣＵ
痘	疒一<首上>Ｄ
嚯	口<雨头>隹Ｈ
莅	艹亻立Ｌ
蛎	虫厂Ｌ
龛	亼口龙Ｋ
谔	讠吅<亏下>Ｅ
槊	<首上>月木Ｓ
豢	豕ＨＮ
胫	月<经角>工Ｊ
仝	人工ＴＧ
佰	亻丆日Ｂ
碜	石厶彡Ｃ
殡	歹穴丘Ｂ
绦	纟夂朩Ｔ
闩	门一ＳＮ
瘀	疒方<冬下>Ｙ
哞	口厶牛Ｍ
蓿	艹宀日Ｘ
驷	马囗儿Ｓ
玖	王丶Ｊ
锲	钅刀大Ｑ
耒	耒ＬＩ一
鄱	丿田阝Ｐ
亟	乛亅一Ｊ
砣	石宀匕Ｔ
濯	氵羽隹Ｚ
俎	人人且Ｚ
糅	米木Ｒ
貅	豸亻木Ｘ
饯	饣一戈Ｊ
溧	氵覀木Ｌ
犴	犭干ＡＮ
诓	讠匚王Ｋ
訇	勹言ＨＧ
嗟	口工Ｊ
莘	艹辛ＳＮ
偈	亻日勹Ｊ
乜	乚ＮＥ
靛	月<足下>Ｄ
郏	夫丷阝Ｊ
栾	<变上>木ＬＮ
葺	艹口耳Ｑ
锃	钅口王Ｚ
螯	敖虫ＡＯ
泫	氵玄ＸＮ
褓	衤口木Ｂ
懋	木木心Ｍ
锉	钅从土Ｃ
镫	钅癶<首上>Ｄ
掾	扌彑<豕下>Ｙ
媾	女<冓上>冂Ｇ
桠	木亚ＹＡ
枰	木干丷Ｐ
萋	艹十女Ｑ
稔	禾今心Ｒ
荻	艹犭火Ｄ
琚	王尸古Ｊ
侩	亻人云Ｋ
蝮	虫夂Ｆ
槁	木<高外>口Ｇ
遴	米夕辶Ｌ
岫	山由ＸＵ
皖	白宀元Ｗ
鹜	攵鸟Ｗ
皈	白又Ｇ
菟	艹兔ＴＵ
蓑	艹亠<衣下>Ｓ
邳	不一阝Ｐ
蔺	艹门隹Ｌ
襁	衤弓虫Ｑ
徉	彳羊ＹＧ
盥	<臼裂>水皿Ｇ
幂	冖日巾Ｍ
觞	用<乃上>Ｓ
炅	日火ＧＩ
貔	豸<囱框>比Ｐ
阡	阝千ＱＮ
呖	口厂力Ｌ
蚨	虫夫ＦＵ
溉	氵<即左>旡Ｇ
懔	忄亠示Ｌ
颧	艹隹页Ｑ
糨	米弓虫Ｊ
虱	乙丿虫Ｓ
蜮	虫戈口Ｙ
舢	舟山ＳＮ
铩	钅乂朩Ｓ
鸷	执鸟ＺＩ
砀	石<乃上><两撇>Ｄ
咭	口吉ＪＩ
腩	月<南上><首上>Ｎ
沆	氵亠几Ｈ
氮	气火火Ｄ
忝	一大Ｔ
抟	扌二<专下>Ｔ
薜	艹尸辛Ｂ
睢	目隹ＳＩ
狴	犭比土Ｂ
烩	火人云Ｈ
缃	纟相ＸＧ
悌	忄丷弓Ｔ
蝾	虫艹木Ｒ
抻	扌日丨Ｃ
猢	犭古月Ｈ
嘞	口革力Ｌ
爻	乂乂ＹＯ
牍	片十头Ｄ
嶷	山矢<足下>Ｙ
蒿	艹<高外>口Ｈ
骅	马<化右>十Ｈ
钹	钅犮ＢＯ
嵇	禾丶山Ｊ
孑	孑ＪＥ乛
俅	亻<求架>丶Ｑ
墒	土<商外><谷下>Ｓ
愎	忄夂Ｂ
囡	囗女ＮＮ
饽	饣十子Ｂ
橐	十口木Ｔ
梏	木口Ｇ
轸	<车旁>人彡Ｚ
纂	目小Ｚ
韪	日<足下>二Ｗ
黢	黑厶夂Ｑ
羸	<赢框>羊ＬＩ
狍	犭勹巳Ｐ
撺	扌穴丨Ｃ
仃	亻丁ＤＧ
殚	歹丷十Ｄ
鬣	镸巛<鼠下>Ｌ
樟	木音十Ｚ
桎	木至ＺＩ
呙	口内ＧＯ
璺	<臼裂>冂王Ｗ
璎	王贝女Ｙ
镏	钅刀田Ｌ
橹	木鱼日Ｌ
祆	礻一大Ｘ
酵	酉耂子Ｊ
徜	彳冂Ｃ
崂	山艹力Ｌ
铀	钅由ＹＵ
榔	木丶阝Ｌ
肓	亡冃ＨＧ
镁	钅大Ｍ
芩	艹今ＱＮ
狲	犭子小Ｓ
铡	钅贝刂Ｚ
祉	礻止ＺＩ
酪	酉各ＬＯ
酗	酉乂凵Ｘ
擢	扌羽隹Ｚ
珐	王土厶Ｆ
鼬	臼<鼠下>由Ｙ
啮	口止凵Ｎ
鹑	<享上>子鸟Ｃ
椿	木日Ｃ
镞	钅<旗角>矢Ｚ
镛	钅广冃Ｙ
蜢	虫子皿Ｍ
檬	木艹<豕下>Ｍ
箔	氵白Ｂ
饨	饣七凵Ｔ
貊	豸丆日Ｍ
馄	饣日比Ｈ
椋	木<享上>小Ｌ
寮	宀大小Ｌ
逦	一冂辶Ｌ
蝌	虫禾斗Ｋ
骢	马<囱框>心Ｃ
蛔	虫囗口Ｈ
辂	<车旁>各ＬＵ
诿	讠禾女Ｗ
伥	亻长ＣＧ
殓	歹亼<应下>Ｌ
挝	扌寸辶Ｗ
诨	讠冖车Ｈ
爿	爿ＰＮ乛
铨	钅人王Ｑ
珲	王冖车Ｈ
楸	木禾火Ｑ
赊	贝人示Ｓ
窳	穴瓜瓜Ｙ
赁	亻壬贝Ｌ
谌	讠其乚Ｃ
聩	耳<贵上>贝Ｋ
煲	亻口火Ｂ
钨	钅乌ＷＵ
茯	艹亻大Ｆ
摺	扌羽白Ｚ
罹	罒忄隹Ｌ
硭	石艹亡Ｍ
掼	扌毌贝Ｇ
蚋	虫内ＲＩ
旮	九日ＧＡ
铣	钅儿Ｘ
絷	执幺小Ｚ
辍	<车旁>又又Ｃ
酊	酉丁ＤＧ
蛐	虫日<临左>Ｑ
暨	<即左>旡一Ｊ
蜇	扌斤虫Ｚ
镝	钅<商外>古Ｄ
肛	月工ＧＧ
莠	艹禾乃Ｙ
砒	石比ＰＩ
邴	一内阝Ｂ
栉	木艹<节下>Ｚ
驺	马彐Ｚ
柠	木宀丁Ｎ
歃	千臼欠Ｓ
鳕	鱼<雨头>彐Ｘ
怼	又寸心Ｄ
訾	止匕言Ｚ
鲧	鱼丿小Ｇ
雒	各隹ＬＯ
酩	酉夕口Ｍ
黩	黑十头Ｄ
耆	耂匕日Ｑ
嘬	口日又Ｚ
孢	子勹巳Ｂ
誊	言ＴＧ
斫	石斤ＺＯ
媸	女屮虫Ｃ
岬	山甲ＪＡ
嵬	山白<见下>Ｗ
泖	氵<卯左>卩Ｍ
蹉	工Ｃ
蟊	虫虫Ｍ
遒	酋辶ＱＵ
缛	纟厂寸Ｒ
轱	<车旁>古ＧＵ
旯	日九ＬＡ
褫	衤几Ｃ
谯	讠隹灬Ｑ
纛	小小Ｄ
僭	亻旡日Ｊ
妁	女勹丶Ｓ
孛	十冖子Ｂ
诟	讠<后上>口Ｇ
闱	门二<韦下>Ｗ
谶	讠从戈Ｃ
虺	一儿虫Ｈ
檑	木<雨头>田Ｌ
榈	木门口Ｌ
跎	宀匕Ｔ
牯	牜古ＧＵ
煨	火田<畏下>Ｗ
悒	忄口巴Ｙ
祧	礻<兆左><兆右>Ｔ
瑗	王爫又Ｙ
闫	门三ＹＮ
蚺	虫冂土Ｒ
獾	犭艹隹Ｈ
揆	扌癶大Ｋ
诙	讠火Ｈ
嫱	女十囗Ｑ
囿	囗冃Ｙ
箸	者ＺＵ
啖	口火火Ｄ
痂	疒加ＪＡ
廿	廿ＮＮ一
赭	土<赤下>者Ｚ
蔗	艹广灬Ｚ
鼹	臼<鼠下>女Ｙ
篙	<高外>口Ｇ
辔	纟纟口Ｐ
椤	木罒夕Ｌ
阒	门目大Ｑ
埠	土<阜上>十Ｂ
伉	亻亠几Ｋ
嫫	女莫ＭＯ
钴	钅古ＧＵ
饴	饣厶口Ｙ
荚	艹夫丷Ｊ
裾	衤尸古Ｊ
弁	厶廾ＢＮ
衢	彳目亍Ｑ
阕	门癶一Ｑ
痔	疒土寸Ｚ
葆	艹亻木Ｂ
蟋	虫丿心Ｘ
锴	钅比白Ｋ
糸	幺小ＭＩ
喑	口音ＹＮ
岿	山<归左>彐Ｋ
豕	豕ＳＩ一
蚪	虫斗ＤＵ
笞	厶口Ｃ
晗	日今口Ｈ
蟀	虫亠十Ｓ
菀	艹宀Ｗ
隍	阝白王Ｈ
逶	禾女辶Ｗ
暝	日冖八Ｍ
茕	艹冖十Ｑ
撷	扌吉页Ｘ
拮	扌吉ＪＥ
獭	犭木贝Ｔ
磔	石<舛右>木Ｚ
滦	氵<变上>木Ｌ
嘁	口戊<卓上>Ｑ
荇	艹彳亍Ｘ
搽	扌艹朩Ｃ
笮	乍ＺＥ
胪	月<卓上>尸Ｌ
滁	氵阝朩Ｃ
泅	氵囗人Ｑ
湎	氵丆罒Ｍ
娩	女<见下>Ｍ
觥	用儿Ｇ
饬	饣力Ｃ
徕	彳未丷Ｌ
闰	门王ＲＮ
掴	扌囗王Ｇ
璜	王八Ｈ
唁	口言ＹＮ
涝	氵艹力Ｌ
汞	工水ＧＧ
傈	亻覀木Ｌ
錾	<车旁>斤金Ｚ
巯	<经角>工<流角>Ｑ
鲽	鱼世木Ｄ
讫	讠乙Ｑ
俚	亻里ＬＩ
姘	女丷开Ｐ
猁	犭禾刂Ｌ
菅	艹宀<官下>Ｊ
耦	耒甲冂Ｏ
荟	艹人云Ｈ
谥	讠<首上>皿Ｓ
绻	纟Ｑ
肱	月厶Ｇ
埙	土口贝Ｘ
铆	钅<卯左>卩Ｍ
琨	王日比Ｋ
狎	犭甲ＸＡ
哙	口人云Ｋ
耄	耂匕毛Ｍ
珉	王巳七Ｍ
挈	丰刀手Ｑ
逑	<求架>丶辶Ｑ
炻	火石ＳＩ
怄	忄匚乂Ｏ
鳝	鱼羊口Ｓ
汛	氵乙十Ｘ
铂	钅白ＢＯ
跹	千辶Ｘ
徭	彳爫缶Ｙ
埂	土一乂Ｇ
颢	日小页Ｈ
猞	犭亼古Ｓ
铖	钅戊Ｃ
蓐	艹厂寸Ｒ
楹	木乃皿Ｙ
貘	豸莫ＭＯ
凼	水凵ＤＧ
赅	贝亥ＧＩ
稹	禾十八Ｚ
镗	钅土Ｔ
癣	疒鱼羊Ｘ
铢	钅朱ＺＵ
裱	衤<衣下>Ｂ
倥	亻穴工Ｋ
涞	氵未丷Ｌ
阆	门丶艮Ｌ
傩	亻又隹Ｎ
钎	钅千ＱＮ
蜉	虫爫子Ｆ
悱	忄非ＦＩ
仄	厂人ＺＥ
粕	米白ＰＯ
纥	纟乙Ｈ
焘	<丰变>寸灬Ｔ
珙	王八Ｇ
栎	木<卬左>小Ｌ
胰	月大弓Ｙ
脔	<变上>内人Ｌ
缳	纟罒<衣下>Ｈ
觜	止匕用Ｚ
锝	钅日寸Ｄ
蕤	艹豕丿Ｒ
唿	口勹心Ｈ
柚	木由ＹＵ
荜	艹比十Ｂ
鲫	鱼<即左>卩Ｊ
洌	氵歹刂Ｌ
螈	虫厂小Ｙ
秆	禾干ＧＮ
骞	宀<冓上>马Ｑ
蕲	艹十斤Ｑ
仵	亻午ＷＵ
苻	艹亻寸Ｆ
斛	用斗Ｈ
搴	宀<冓上>手Ｑ
瘙	疒又虫Ｓ
獍	犭音儿Ｊ
郗	乂阝Ｘ
醴	酉日<首上>Ｌ
铬	钅各ＧＥ
篁	白王Ｈ
杷	木巴ＰＡ
烊	火羊ＹＧ
郜	口阝Ｇ
纩	纟广ＫＧ
脍	月人云Ｋ
鹂	一冂鸟Ｌ
牝	牜匕ＰＮ
骈	马丷开Ｐ
莳	艹日寸Ｓ
熨	尸寸火Ｙ
钿	钅田ＤＮ
冼	冫儿Ｘ
柑	木廿一Ｇ
孀	女<雨头>相Ｓ
恚	圭心ＨＩ
氦	气亥ＨＩ
湟	氵白王Ｈ
锒	钅丶艮Ｌ
锌	钅辛ＸＮ
鹬	冂鸟Ｙ
戕	爿戈ＱＧ
缦	纟日又Ｍ
虻	虫亡ＭＧ
篾	罒戊Ｍ
衽	衤壬ＲＮ
帏	巾二<韦下>Ｗ
轾	<车旁>至ＺＩ
碣	石日勹Ｊ
膂	<旗角>丿冃Ｌ
堞	土世木Ｄ
暾	日<享上>攵Ｔ
鼐	乃<鼎左><鼎右>Ｎ
炝	火人Ｑ
窨	穴音ＹＮ
鲟	鱼彐寸Ｘ
偬	亻勹心Ｚ
硌	石各ＧＥ
恽	忄冖车Ｙ
咴	口火Ｈ
竦	立木口Ｓ
邰	厶口阝Ｔ
虢	爫寸几Ｇ
覃	覀日十Ｑ
韭	非一ＪＵ
蕨	艹厂欠Ｊ
铉	钅玄ＸＮ
泵	石水ＢＧ
帧	巾<卓上>贝Ｚ
胱	月儿Ｇ
缟	纟<高外>口Ｇ
屐	尸彳又Ｊ
苌	艹长ＣＧ
腱	月<秉中>廴Ｊ
侔	亻厶牛Ｍ
鳃	鱼田心Ｓ
讦	讠干ＪＥ
圻	土斤ＱＩ
椽	木彑<豕下>Ｃ
癯	疒目隹Ｑ
灏	氵日页Ｈ
洮	氵<兆左><兆右>Ｔ
拊	扌亻寸Ｆ
眙	目厶口Ｙ
尜	小大小Ｇ
骝	马刀田Ｌ
髭	镸止匕Ｚ
蝰	虫大圭Ｋ
痨	疒艹力Ｌ
竽	于ＹＵ
狯	犭人云Ｋ
剡	火火刂Ｓ
鼋	元口乚Ｙ
腚	月宀<足下>Ｄ
猱	犭木Ｎ
辚	<车旁>米<舛右>Ｌ
螫	土攵虫Ｓ
缢	纟<首上>皿Ｙ
酶	酉母Ｍ
嘌	口覀示Ｐ
椴	木<段左>殳Ｄ
洹	氵一一Ｈ
趺	夫ＦＵ
盱	目于ＸＵ
犍	牜<秉中>廴Ｊ
镊	钅耳又Ｎ
噻	口宀土Ｓ
庹	广廿尺Ｔ
钙	钅一<亏下>Ｇ
赡	贝言Ｓ
罅	缶虍丨Ｘ
珥	王耳ＥＲ
狃	犭丑ＮＵ
镙	钅田小Ｌ
撄	扌贝女Ｙ
圩	土于ＸＵ
杌	木一儿Ｗ
峄	山又<举下>Ｙ
箴	戊一Ｚ
炔	火夬ＱＥ
茔	艹冖土Ｙ
墉	土广冃Ｙ
鏊	敖金ＡＯ
焙	火立口Ｂ
馏	饣刀田Ｌ
畲	人示田Ｓ
欹	大可欠Ｑ
洇	氵囗大Ｙ
吡	口比ＢＩ
仟	亻千ＱＮ
馐	饣丑Ｘ
宥	宀冃Ｙ
鼍	吅田乚Ｔ
苫	艹占ＳＮ
囹	囗今丶Ｌ
荛	艹<尧上>儿Ｒ
氯	气<录上>水Ｌ
昃	日厂人Ｚ
缱	纟<贵上>辶Ｑ
峤	山丿<齐下>Ｊ
龈	止凵艮Ｙ
睇	目丷弓Ｄ
娈	<变上>女ＬＮ
蹼	业丶Ｐ
榛	木禾Ｚ
蟥	虫八Ｈ
臬	自木ＮＥ
殳	殳ＳＵ丿
擀	扌人干Ｇ
旄	<旗角>毛ＭＯ
犰	犭九ＱＵ
彀	士弓殳Ｇ
狁	犭厶儿Ｙ
诤	讠亅Ｚ
傣	亻氺Ｄ
裢	衤车辶Ｌ
搠	扌<首上>月Ｓ
樨	木尸牛Ｘ
鹌	大乚鸟Ａ
踟	矢口Ｃ
铰	钅亠父Ｊ
焖	火门心Ｍ
痢	疒禾刂Ｌ
锰	钅子皿Ｍ
厣	厂大甲Ｙ
瘐	疒臼人Ｙ
蠹	十虫虫Ｄ
楫	木口耳Ｊ
澧	氵日<首上>Ｌ
郓	冖车阝Ｙ
秸	禾吉ＪＥ
砦	止匕石Ｚ
璁	王<囱框>心Ｃ
柞	木乍ＺＯ
纫	纟刀丶Ｒ
纡	纟于ＹＵ
腭	月吅<亏下>Ｅ
骐	马其ＱＩ
黟	黑夕夕Ｙ
瘿	疒贝女Ｙ
捭	扌卑ＢＩ
芨	艹及ＪＩ
笳	加ＪＡ
嵯	山工Ｃ
颏	亥页ＫＥ
郧	口贝阝Ｙ
妣	女比ＢＩ
钾	钅甲ＪＡ
酃	<雨头>吅阝Ｌ
圄	囗五口Ｙ
稞	禾日木Ｋ
苡	艹以ＹＩ
杼	木<予下>Ｚ
戡	其乚戈Ｋ
勐	子皿力Ｍ
薨	艹歹匕Ｈ
蛉	虫今丶Ｌ
澍	氵吉寸Ｓ
雩	<雨头>二<亏下>Ｙ
骘	阝止马Ｚ
憷	忄林<足下>Ｃ
茴	艹囗口Ｈ
诜	讠儿Ｓ
淖	氵<卓上>十Ｎ
筅	儿Ｘ
佚	亻失ＹＩ
襦	衤<雨头><而下>Ｒ
郇	勹日阝Ｈ
吖	口丷丨Ａ
檫	木宀示Ｃ
帔	巾皮ＰＩ
垭	土亚ＹＡ
凫	<鸟上>几ＦＵ
鹗	吅<亏下>鸟Ｅ
钯	钅巴ＢＡ
邗	干阝ＨＮ
舛	夕<舛右>ＣＮ
謇	宀<冓上>言Ｊ
荠	艹文<齐下>Ｊ
佤	亻瓦ＷＡ
矽	石夕ＸＩ
喁	口甲冂Ｙ
粑	米巴ＢＡ
垓	土亥ＧＩ
苕	艹刀口Ｓ
浔	氵彐寸Ｘ
芫	艹元ＹＮ
煸	火户冊Ｂ
蝓	虫亼<前下>Ｙ
迓	一<牙下>辶Ｙ
杓	木勹丶Ｂ
躅	罒勹Ｚ
褡	衤艹口Ｄ
矾	石几丶Ｆ
喈	口比白Ｊ
沔	氵一Ｍ
樘	木土Ｔ
锨	钅斤欠Ｘ
蜊	虫禾刂Ｌ
搦	扌弓弓Ｎ
鲵	鱼臼儿Ｎ
烷	火宀元Ｗ
蕈	艹覀十Ｘ
刭	<经角>工刂Ｊ
幛	巾音十Ｚ
踯	丷阝Ｚ
堠	土<候角>矢Ｈ
闼	门大辶Ｔ
愀	忄禾火Ｑ
鄯	羊口阝Ｓ
缁	纟巛田Ｚ
氰	气月Ｑ
瓤	亠<衣下>瓜Ｒ
肜	月彡ＲＧ
摈	扌穴丘Ｂ
氟	气弓<齐下>Ｆ
瀣	氵又一Ｘ
鲰	鱼耳又Ｚ
怫	忄弓<齐下>Ｆ
坩	土廿一Ｇ
陉	阝<经角>工Ｘ
疟	疒<虐下>ＹＯ
褰	宀<冓上><衣下>Ｑ
渑	氵口乚Ｍ
笫	<亏下>丿Ｚ
裣	衤亼<应下>Ｌ
菸	艹方<冬下>Ｙ
痼	疒囗古Ｇ
阄	门日Ｊ
缗	纟巳日Ｍ
媪	女日皿Ａ
疱	疒勹巳Ｐ
悭	忄又土Ｑ
尻	尸九ＫＯ
罴	罒土灬Ｐ
燹	豕豕火Ｘ
疥	疒人<齐下>Ｊ
衿	衤今ＪＮ
艏	舟<首上>自Ｓ
亳	<亮上>丿七Ｂ
邛	工阝ＱＧ
眭	目圭ＳＩ
旒	<旗角><充上><流角>Ｌ
茏	艹龙ＬＧ
樯	木十囗Ｑ
艄	舟冃Ｓ
孳	<首上>幺子Ｚ
鲶	鱼今心Ｎ
卅	卅ＳＡ一
黍	禾人氺Ｓ
鲑	鱼圭ＧＩ
氖	气乃ＮＩ
怛	忄日一Ｄ
枋	木方ＦＧ
蒹	艹<首上><兼末>Ｊ
菘	艹木厶Ｓ
豌	一<首上>Ｗ
泶	<学上>水ＸＥ
笏	勹<两撇>Ｈ
忉	忄刀ＤＯ
淝	氵月巴Ｆ
榉	木<应下><举下>Ｊ
踽	丿冂Ｊ
廪	广亠示Ｌ
裎	衤口王Ｃ
桁	木彳亍Ｈ
萑	艹隹ＨＮ
濂	氵广<兼末>Ｌ
鲈	鱼<卓上>尸Ｌ
疹	疒人彡Ｚ
逋	甫辶ＢＵ
栳	木耂匕Ｌ
蚍	虫比ＰＩ
苒	艹冂土Ｒ
蝣	虫<旗角>子Ｙ
铙	钅<尧上>儿Ｎ
殍	歹爫子Ｐ
陂	阝皮ＢＩ
埚	土口内Ｇ
麂	<鹿上>比几Ｊ
妊	女壬ＲＮ
唢	口贝Ｓ
锗	钅者ＺＥ
擘	尸辛手Ｂ
趸	丆足Ｄ
赍	十从贝Ｊ
谰	讠门木Ｌ
歙	亼羽欠Ｓ
縻	广林小Ｍ
焯	火<卓上>十Ｚ
矬	矢从土Ｃ
烯	火乂巾Ｘ
荩	艹尺<冬下>Ｊ
艨	舟艹<豕下>Ｍ
眇	目少ＭＯ
瓴	今丶瓦Ｌ
亍	亍ＣＵ一
佧	亻<卓上>下Ｋ
叻	口力ＬＥ
箝	扌廿Ｑ
勰	力力心Ｘ
氨	气宀女Ａ
喱	口厂里Ｌ
飨	<乡上>丿食Ｘ
翥	者羽ＺＵ
侪	亻文<齐下>Ｃ
桫	木氵少Ｓ
鲠	鱼一乂Ｇ
茑	艹鸟ＮＯ
蚝	虫毛ＨＯ
跗	亻寸Ｆ
焓	火今口Ｈ
洄	氵囗口Ｈ
疽	疒且ＪＵ
笤	刀口Ｔ
篦	<囱框>比Ｂ
鹕	古月鸟Ｈ
雎	且隹ＪＵ
胺	月宀女Ａ
蹰	厂寸Ｃ
阋	门臼儿Ｘ
钬	钅火ＨＯ
镪	钅弓虫Ｑ
馕	饣十<衣下>Ｎ
艟	舟立里Ｃ
毂	士<车旁>殳Ｇ
鹈	丷丿鸟Ｔ
庠	广羊ＸＧ
猗	犭大可Ｙ
瞽	吉十目Ｇ
疴	疒可ＫＥ
踅	扌斤足Ｘ
棼	林八刀Ｆ
睾	丿罒十Ｇ
鹳	艹隹鸟Ｇ
疡	疒<乃上><两撇>Ｙ
锍	钅<充上><流角>Ｌ
漭	氵艹廾Ｍ
跸	比十Ｂ
醮	酉隹灬Ｊ
砬	石立ＬＡ
濉	氵目隹Ｓ
柢	木<卬左>七Ｄ
泷	氵龙ＬＧ
逄	夂<舛右>辶Ｐ
埘	土日寸Ｓ
陟	阝止<步下>Ｚ
耋	耂匕至Ｄ
笄	开ＪＩ
蚧	虫人<齐下>Ｊ
蝥	攵虫Ｍ
塄	土罒方Ｌ
萘	艹大示Ｎ
郯	火火阝Ｔ
烃	火<经角>工Ｔ
酮	酉冂一Ｔ
彖	彑<豕下>ＴＮ
痫	疒门木Ｘ
鼙	吉十卑Ｐ
掮	扌户冃Ｑ
趿	及ＴＡ
帑	女又巾Ｔ
馔	饣巳八Ｚ
鲇	鱼占ＮＮ
畦	田圭ＱＩ
蚜	虫一<牙下>Ｙ
枸	木勹口Ｇ
狷	犭口冃Ｊ
尢	尢ＹＵ一
稗	禾卑ＢＩ
窠	穴日木Ｋ
溘	氵土皿Ｋ
矸	石干ＧＮ
岢	山可ＫＥ
沭	氵木丶Ｓ
钲	钅一止Ｚ
蠃	<赢框>虫ＬＯ
睃	目厶夂Ｓ
庾	广臼人Ｙ
扦	扌千ＱＮ
鸱	<卬左>七鸟Ｃ
哚	口几木Ｄ
菔	艹月又Ｆ
枥	木厂力Ｌ
轳	<车旁><卓上>尸Ｌ
蟛	虫吉彡Ｐ
觋	工从见Ｘ
祜	礻古ＨＵ
蚰	虫由ＹＵ
狳	犭亼朩Ｙ
倬	亻<卓上>十Ｚ
锱	钅巛田Ｚ
蛄	虫古ＧＵ
醪	酉羽彡Ｌ
囟	<囱框>乂ＸＮ
爰	爫<干变>又Ｙ
奁	大匚乂Ｌ
擤	扌自丌Ｘ
槎	木工Ｃ
鞒	革丿<齐下>Ｑ
嬗	女亠一Ｓ
嗉	口小Ｓ
鳐	鱼爫缶Ｙ
柘	木石ＺＥ
毖	比心丿Ｂ
舸	舟可ＧＥ
镍	钅自木Ｎ
鋈	氵丿金Ｗ
潆	氵艹小Ｙ
侑	亻冃Ｙ
谘	讠欠口Ｚ
耔	耒子ＺＩ
锕	钅阝可Ａ
豳	山豕豕Ｂ
芾	艹一巾Ｆ
乩	占乚ＪＩ
渌	氵<录上>水Ｌ
禳	礻亠<衣下>Ｒ
綦	其幺小Ｑ
锑	钅丷弓Ｔ
钤	钅今ＱＮ
砭	石丿之Ｂ
鳏	鱼罒<冬下>Ｇ
辊	<车旁>日比Ｇ
娠	女厂<辰内>Ｓ
鬻	弓弓冂Ｙ
洙	氵朱ＺＵ
墀	土尸牛Ｃ
孥	女又子Ｎ
疣	疒尢丶Ｙ
茇	艹犮ＢＡ
耪	耒<旁上>方Ｐ
芪	艹<卬左>七Ｑ
愆	彳亍心Ｑ
筮	工从Ｓ
榫	木隹十Ｓ
栀	木<后上>Ｚ
薅	艹女寸Ｈ
萁	艹其ＱＩ
蜞	虫其ＱＩ
蛩	工几虫Ｑ
罨	罒大乚Ｙ
鳟	鱼酋寸Ｚ
阍	门<卬左>七Ｈ
龃	止凵且Ｊ
莰	艹土欠Ｋ
酽	酉亚丿Ｙ
栲	木耂丂Ｋ
氪	气古儿Ｋ
崤	山乂冃Ｘ
啁	口<周框>土Ｚ
铋	钅心丿Ｂ
碘	石冂八Ｄ
觚	用瓜Ｇ
毽	毛<秉中><举下>Ｊ
捌	扌另刂Ｂ
樾	木走戈Ｙ
瘢	疒舟殳Ｂ
茌	艹亻士Ｃ
鹚	<首上>幺鸟Ｃ
骶	骨<卬左>七Ｄ
菏	<艹氵>可ＨＥ
糁	米厶彡Ｓ
穑	禾十囗Ｓ
溏	氵广口Ｔ
刖	月刂ＹＥ
嫜	女音十Ｚ
螽	夂虫虫Ｚ
缒	纟<阜上>辶Ｚ
滹	氵虍丨Ｈ
髋	骨宀见Ｋ
攮	扌十<衣下>Ｎ
楂	木木一Ｃ
戽	户斗ＨＵ
铧	钅<化右>十Ｈ
囝	囗子ＮＮ
愍	巳攵心Ｍ
坭	土尸匕Ｎ
熵	火<商外><谷下>Ｓ
澶	氵亠一Ｃ
鲂	鱼方ＦＧ
鞯	革艹子Ｊ
橛	木厂欠Ｊ
飧	夕食ＳＮ
痈	疒用ＹＧ
枞	木从ＺＧ
殂	歹且ＣＵ
冱	冫一彑Ｈ
匏	大<亏下>勹Ｐ
蠼	虫目又Ｑ
嵊	山禾<北左>Ｓ
艉	舟尸毛Ｗ
岙	丿大山Ａ
樗	木<雨头><亏下>Ｃ
遄	山丆辶Ｃ
舂	臼ＣＧ
椟	木十头Ｄ
尕	乃小ＧＡ
柙	木甲ＸＡ
伧	亻人Ｃ
坻	土<卬左>七Ｃ
瓠	大<亏下>瓜Ｈ
镬	钅艹又Ｈ
髡	镸彡儿Ｋ
薮	艹女攵Ｓ
蔌	艹木欠Ｓ
龉	止凵口Ｙ
鹾	<卓上>囗工Ｃ
讣	讠卜ＦＵ
皲	冖车皮Ｊ
髁	骨日木Ｋ
杲	日木ＧＯ
芰	艹十又Ｊ
椐	木尸古Ｊ
橼	木彑<豕下>Ｙ
缯	纟丷日Ｚ
鸹	舌鸟ＧＡ
龋	止凵冂Ｑ
莪	艹手戈Ｅ
锞	钅日木Ｋ
圹	土广ＫＧ
黧	禾勹黑Ｌ
隈	阝田<畏下>Ｗ
彘	彑矢比Ｚ
暌	日癶大Ｋ
餍	厂大食Ｙ
赜	匚贝Ｚ
筚	比十Ｂ
泔	氵廿一Ｇ
嘏	古<右框>又Ｇ
疠	疒丆Ｌ
鸬	<卓上>尸鸟Ｌ
檠	艹攵木Ｑ
饧	饣<乃上><两撇>Ｘ
醯	酉<充上>皿Ｘ
蚬	虫见ＸＮ
蓖	艹<囱框>比Ｂ
哏	口艮ＧＮ
蹁	户冊Ｐ
朐	月勹口Ｑ
疋	乛<足下>ＳＵ
甑	丷日瓦Ｚ
绂	纟犮ＦＵ
铗	钅夫丷Ｊ
髫	镸彡口Ｔ
螅	虫自心Ｘ
宄	宀九ＧＩ
芎	艹弓ＸＧ
摭	扌广灬Ｚ
膣	月穴至Ｚ
苷	艹廿一Ｇ
骟	马户羽Ｓ
圯	土巳ＹＩ
棹	木<卓上>十Ｚ
枳	木口八Ｚ
啭	口二<专下>Ｚ
蔟	艹<旗角>矢Ｃ
妫	女<冬下>力Ｇ
鍪	攵金Ｍ
夤	夕穴一Ｙ
牖	片户甫Ｙ
觯	用十Ｚ
棰	木千<垂下>Ｃ
盍	土厶皿Ｈ
茭	艹亠父Ｊ
耨	耒厂寸Ｎ
鞣	革木Ｒ
钡	钅贝ＢＩ
礅	石<享上>攵Ｄ
苴	艹且ＪＵ
熘	火刀田Ｌ
硼	石月月Ｐ
秫	禾木丶Ｓ
铊	钅宀匕Ｔ
柁	木宀匕Ｄ
壅	亠<乡上>土Ｙ
飑	风勹巳Ｂ
膈	月一冂Ｇ
钪	钅亠几Ｋ
箜	穴工Ｋ
缡	纟文冂Ｌ
醚	酉米辶Ｍ
敉	米攵ＭＩ
甯	宀心<甬下>Ｎ
潍	氵纟隹Ｗ
寤	宀爿口Ｗ
肄	匕矢<举下>Ｙ
阈	门戈口Ｙ
跏	加ＪＡ
栊	木龙ＬＧ
栌	木<卓上>尸Ｌ
涑	氵木口Ｓ
脘	月宀元Ｗ
酎	酉寸ＺＵ
柒	氵七木Ｑ
谵	讠言Ｚ
鲳	鱼日日Ｃ
茈	艹止匕Ｃ
痱	疒非ＦＩ
鬈	镸彡Ｑ
蛳	虫一巾Ｓ
秭	禾丿<亏下>Ｚ
阏	门方人Ｙ
捩	扌户大Ｌ
镆	钅莫ＭＯ
枇	木比ＰＩ
枵	木口丂Ｘ
氚	气川ＣＮ
皴	厶夂皮Ｃ
堀	土尸山Ｋ
讴	讠匚乂Ｏ
圊	囗月Ｑ
穰	禾亠<衣下>Ｒ
蟮	虫羊口Ｓ
笥	口Ｓ
焐	火五口Ｗ
菖	艹日日Ｃ
绐	纟厶口Ｄ
儋	亻言Ｄ
邡	方阝ＦＧ
蓼	艹羽彡Ｌ
蒌	艹米女Ｌ
圮	土己ＰＩ
浠	氵乂巾Ｘ
廨	广牛Ｘ
怙	忄古ＨＵ
闶	门亠几Ｋ
瓿	立口瓦Ｂ
诂	讠古ＧＵ
粳	米一乂Ｊ
鳓	鱼革力Ｌ
漯	氵田小Ｌ
眚	丿目Ｓ
庑	广<干变>乚Ｗ
苎	艹宀一Ｎ
觳	士用殳Ｈ
楗	木<秉中>廴Ｊ
徼	彳白攵Ｊ
莨	艹丶艮Ｌ
黥	黑<享上>小Ｑ
芴	艹勹<两撇>Ｗ
酰	酉儿Ｘ
柽	木又土Ｃ
钭	钅斗ＴＵ
揿	扌钅欠Ｑ
蓊	艹八羽Ｗ
馑	饣廿Ｊ
喾	<学上>口Ｋ
僳	亻覀米Ｓ
揎	扌宀一Ｘ
挹	扌口巴Ｙ
芏	艹土ＤＵ
剀	山己刂Ｋ
愦	忄<贵上>贝Ｋ
曩	日亠<衣下>Ｎ
袢	衤半ＰＮ
酾	酉一冂Ｓ
硒	石西ＸＩ
曛	日千黑Ｘ
俣	亻口大Ｙ
笊	爪ＺＯ
卮	<后上>ＺＩ
汊	氵又丶Ｃ
郴	林阝ＣＮ
雠	隹讠隹Ｃ
鲷	鱼<周框>土Ｄ
仂	亻力ＬＥ
莴	艹口内Ｗ
癍	疒王王Ｂ
榧	木匚非Ｆ
鹣	<首上><兼末>鸟Ｊ
蘖	艹<阜上>木Ｎ
旆	<旗角>一巾Ｐ
蕖	<艹氵>匚木Ｑ
桡	木<尧上>儿Ｒ
荪	艹子小Ｓ
婺	攵女Ｗ
妯	女由ＺＵ
钣	钅又Ｂ
垆	土<卓上>尸Ｌ
沤	氵匚乂Ｏ
屣	尸彳<足下>Ｘ
卺	乛水Ｊ
嫠	未厂女Ｌ
蘼	艹广非Ｍ
坶	土母ＭＵ
蘧	艹虍辶Ｑ
镒	钅<首上>皿Ｙ
蕞	艹耳又Ｚ
玢	王八刀Ｂ
厝	厂日Ｃ
锆	钅口Ｇ
鬲	一口冂Ｇ
詈	罒言ＬＩ
箧	匚夫Ｑ
铴	钅氵<乃上>Ｔ
怃	忄<干变>乚Ｗ
浜	氵丘八Ｂ
鳔	鱼覀示Ｂ
缶	缶ＦＵ丿
藿	艹<雨头>隹Ｈ
蛑	虫厶牛Ｍ
柰	木示ＮＩ
鼗	<兆左><首上>又Ｔ
蓥	艹冖金Ｙ
欤	与欠ＹＵ
钚	钅不ＢＵ
蛞	虫舌ＫＯ
娌	女里ＬＩ
鲆	鱼干丷Ｐ
癔	疒音心Ｙ
鄣	音十阝Ｚ
酢	酉乍ＣＵ
骖	马厶彡Ｃ
酲	酉口王Ｃ
碓	石隹ＤＩ
妗	女今ＪＮ
麈	<鹿上>比主Ｚ
傧	亻穴丘Ｂ
燔	火丿田Ｆ
黻	业巾犮Ｆ
缂	纟革ＫＥ
鹩	大小鸟Ｌ
碛	石贝Ｑ
铱	钅亠<衣下>Ｙ
塬	土厂小Ｙ
韫	二<韦下>皿Ｙ
揸	扌木一Ｚ
趵	勹丶Ｂ
屙	尸阝可Ｅ
猓	犭日木Ｇ
檩	木亠示Ｌ
谝	讠户冊Ｐ
笸	匚口Ｐ
蜣	虫乚Ｑ
溽	氵厂寸Ｒ
蜩	虫<周框>土Ｔ
乇	丿七ＴＯ
痦	疒五口Ｗ
赀	止匕贝Ｚ
萏	艹臼Ｄ
偾	亻十贝Ｆ
鄄	覀土阝Ｊ
岘	山见ＸＮ
揠	扌匚日Ｙ
伛	亻匚乂Ｙ
碚	石立口Ｂ
阊	门日日Ｃ
蕺	艹耳戈Ｊ
孓	乛亅丶Ｊ
镧	钅门木Ｌ
锊	钅爫寸Ｌ
铍	钅皮ＰＩ
溱	氵禾Ｑ
昝	夂卜日Ｚ
胙	月乍ＺＯ
瑷	王<爱上>又Ａ
邶	<北左>匕阝Ｂ
坫	土占ＤＮ
伲	亻尸匕Ｎ
芑	艹己ＱＩ
缬	纟吉页Ｘ
硎	石开刂Ｘ
镟	钅<旗角><足下>Ｘ
糌	米卜日Ｚ
隹	隹ＣＩ丿
坼	土斤丶Ｃ
幞	巾业丶Ｆ
戢	口耳戈Ｊ
崃	山未丷Ｌ
髀	骨卑ＢＩ
忭	忄亠卜Ｂ
箪	丷十Ｄ
瞢	艹罒目Ｍ
筌	人王Ｑ
菽	艹小又Ｓ
荨	艹彐寸Ｑ
郅	至阝ＺＩ
锛	钅大廾Ｂ
笾	力辶Ｂ
篪	几Ｃ
辏	<车旁>大Ｃ
癜	疒尸殳Ｄ
钒	钅几丶Ｆ
哕	口山夕Ｈ
敫	白方攵Ｊ
廑	广廿Ｊ
鲢	鱼车辶Ｌ
仳	亻比ＰＩ
厍	厂车ＳＥ
砷	石日丨Ｓ
蓍	艹耂日Ｓ
鳎	鱼日羽Ｔ
圬	土二<亏下>Ｗ
欷	乂欠Ｘ
碹	石宀一Ｘ
甏	吉彡瓦Ｂ
檗	尸辛木Ｂ
豉	一<首上>又Ｃ
淦	氵金ＧＮ
磙	石亠<衣下>Ｇ
苣	艹匚<右框>Ｊ
艿	艹乃ＮＩ
颞	耳又页Ｎ
嗍	口<首上>月Ｓ
胝	月<卬左>七Ｚ
槠	木讠者Ｚ
诼	讠豕丶Ｚ
诹	讠耳又Ｚ
麸	夂夫Ｆ
蛱	虫夫丷Ｊ
鞫	革勹言Ｊ
锂	钅里ＬＩ
荞	艹丿<齐下>Ｑ
轫	<车旁>刀丶Ｒ
椹	木其乚Ｓ
郾	匚日阝Ｙ
楱	木大Ｃ
迨	厶口辶Ｄ
氘	气<齐下>ＤＯ
槲	木斗Ｈ
耩	耒<冓上>冂Ｊ
熳	火日又Ｍ
缌	纟田心Ｓ
恂	忄勹日Ｘ
铟	钅囗大Ｙ
卣	<卓上>囗<右框>Ｙ
唣	口白七Ｚ
苁	艹从ＣＧ
裉	衤艮ＫＮ
瘰	疒田小Ｌ
泺	氵<卬左>小Ｌ
锘	钅艹口Ｎ
璩	王虍豕Ｑ
薹	艹吉土Ｔ
阌	门<爱上>又Ｗ
堙	土覀土Ｙ
茺	艹<充上>儿Ｃ
砩	石弓<齐下>Ｆ
蓠	艹文冂Ｌ
啉	口林ＬＮ
黾	口日乚Ｍ
诒	讠厶口Ｙ
唑	口从土Ｚ
砗	石车ＣＥ
羝	<卬左>七Ｄ
顸	干页ＨＮ
刳	大<亏下>刂Ｋ
杩	木马ＭＡ
俳	亻非ＰＩ
慊	忄<首上><兼末>Ｑ
缫	纟巛木Ｓ
茼	艹冂一Ｔ
狺	犭言ＹＮ
缍	纟千<垂下>Ｄ
圪	土乙Ｇ
麇	<鹿上>比禾Ｊ
悝	忄里ＫＩ
尥	尢勹丶Ｌ
狨	犭戈Ｒ
铯	钅巴Ｓ
嗾	口<旗角>矢Ｓ
胗	月人彡Ｚ
痤	疒从土Ｃ
隳	阝Ｈ
镢	钅厂欠Ｊ
鹋	艹田鸟Ｍ
槭	木戊<卓上>Ｑ
畹	田宀Ｗ
嵛	山亼<前下>Ｙ
饫	饣丿大Ｙ
蘩	艹小Ｆ
赓	广<秉中>贝Ｇ
绲	纟日比Ｇ
翮	一冂羽Ｈ
郐	人云阝Ｋ
缧	纟田小Ｌ
酹	酉爫寸Ｌ
唛	口夂Ｍ
颟	艹两页Ｍ
蠓	虫艹<豕下>Ｍ
眄	目一Ｍ
葚	艹其乚Ｒ
腧	月亼<前下>Ｓ
溲	氵叟ＳＵ
溻	氵日羽Ｔ
踬	贝Ｚ
怍	忄乍ＺＯ
畚	厶大田Ｂ
嬖	尸辛女Ｂ
糍	米<首上>幺Ｃ
旰	日干ＧＮ
鞲	革<冓上>冂Ｇ
涫	氵宀<官下>Ｇ
颃	亠几页Ｈ
荭	艹纟工Ｈ
嵴	山<脊右>月Ｊ
垲	土山己Ｋ
呒	口<干变>乚Ｍ
胼	月丷开Ｐ
芡	艹欠ＱＮ
朊	月元ＲＮ
馓	饣攵Ｓ
跣	儿Ｘ
刈	乂刂ＹＩ
萸	艹臼人Ｙ
龠	亼吅冊Ｙ
帻	巾贝Ｚ
瘳	疒羽彡Ｃ
疸	疒日一Ｄ
磴	石癶<首上>Ｄ
陔	阝亥ＧＩ
醢	酉皿Ｈ
踺	<秉中>廴Ｊ
蠲	<首上>皿勹Ｊ
蛸	虫冃Ｓ
硖	石夫丷Ｘ
鲞	鱼ＸＧ
蚴	虫幺力Ｙ
镲	钅宀示Ｃ
戥	日戈Ｄ
葑	艹圭寸Ｆ
篌	亻矢Ｈ
栝	木舌ＧＡ
耧	耒米女Ｌ
峁	山<卯左>卩Ｍ
堋	土月月Ｐ
芘	艹比ＰＩ
謦	士殳言Ｑ
鸲	勹口鸟Ｑ
颡	又木页Ｓ
鄞	廿阝Ｙ
嗌	口<首上>皿Ａ
踔	<卓上>十Ｃ
疔	疒丁ＤＧ
铒	钅耳ＥＲ
桄	木儿Ｇ
屦	尸彳女Ｊ
侉	亻大<亏下>Ｋ
粝	米厂Ｌ
瘘	疒米女Ｌ
痧	疒氵少Ｓ
绨	纟丷弓Ｄ
葸	艹田心Ｘ
薏	艹音心Ｙ
仉	亻几ＺＧ
廛	广里土Ｃ
簟	覀十Ｄ
裰	衤又又Ｄ
畈	田又Ｆ
鲋	鱼亻寸Ｆ
舻	舟<卓上>尸Ｌ
皤	白丿田Ｐ
嗪	口禾Ｑ
凇	冫八厶Ｓ
谇	讠亠十Ｓ
掭	扌一Ｔ
燠	火<向框>大Ｙ
虿	丆虫Ｃ
莼	艹纟七Ｃ
毳	毛毛毛Ｃ
簦	癶<首上>Ｄ
蹀	世木Ｄ
胍	月瓜ＧＡ
缣	纟<首上><兼末>Ｊ
枧	木见ＪＮ
鲮	鱼土夂Ｌ
陧	阝日土Ｎ
泮	氵半ＰＮ
梃	木壬廴Ｔ
醑	酉乛冃Ｘ
勖	<冒上>目力Ｘ
谖	讠爫又Ｘ
谳	讠大丶Ｙ
铘	钅一阝Ｙ
轭	<车旁>厂Ｅ
酐	酉干ＧＮ
庋	广十又Ｇ
僬	亻隹灬Ｊ
贶	贝口儿Ｋ
醅	酉立口Ｐ
蝤	虫酋ＱＵ
垧	土<向框>口Ｓ
锬	钅火火Ｔ
趑	走冫欠Ｚ
菹	<艹氵>且ＺＵ
龀	止凵<化右>Ｃ
藁	艹<高外>木Ｇ
诖	讠圭ＧＡ
匦	匚<车旁>九Ｇ
笕	见ＪＮ
硷	石亼<应下>Ｊ
锩	钅Ｊ
垅	土龙ＬＧ
肭	月内ＮＡ
陴	阝卑ＰＩ
吣	口心ＱＮ
醛	酉艹王Ｑ
蒴	艹<屮变>月Ｓ
邾	朱阝ＺＵ
鳊	鱼户冊Ｂ
鸸	丆<而下>鸟Ｅ
桴	木爫子Ｆ
搿	亼手Ｇ
胲	月亥ＨＩ
剞	大可刂Ｊ
鬏	镸禾火Ｊ
芤	艹子乚Ｋ
嵝	山米女Ｌ
艋	舟子皿Ｍ
悛	忄厶夂Ｑ
疝	疒山ＳＮ
柝	木斤丶Ｔ
鲔	鱼冃Ｗ
拶	扌巛夕Ｚ
黹	业丷巾Ｚ
舯	舟中ＺＧ
箅	田丌Ｂ
榇	木立朩Ｃ
菰	艹子瓜Ｇ
煳	火古月Ｈ
劂	厂丷刂Ｊ
蚵	虫可ＨＥ
礞	石艹<豕下>Ｍ
钼	钅目ＭＵ
嬲	田力力Ｎ
劬	勹口力Ｑ
肽	月大丶Ｔ
洧	氵冃Ｗ
硪	石手戈Ｗ
葙	艹相ＸＧ
埸	土日勹Ｙ
躜	贝Ｚ
鬯	乂凵匕Ｃ
鲱	鱼非ＦＩ
砜	石风ＦＧ
呋	口夫ＦＵ
莩	艹爫子Ｆ
鹨	羽彡鸟Ｌ
墁	土日又Ｍ
觫	用木Ｓ
辋	<车旁>冂<首上>Ｗ
隰	阝日灬Ｘ
獯	犭千黑Ｘ
佾	亻八冃Ｙ
媵	月女Ｙ
趱	走Ｚ
髌	骨穴丘Ｂ
埕	土口王Ｃ
谠	讠儿Ｄ
碲	石<旁上>巾Ｄ
垤	土至ＤＥ
唪	口<举下>Ｆ
绀	纟廿一Ｇ
铪	钅亼口Ｈ
洚	氵夂<舛右>Ｊ
嫘	女田小Ｌ
楝	木木<黑上>Ｌ
甍	艹罒瓦Ｍ
髂	骨宀各Ｑ
磲	石匚木Ｑ
绱	纟冂Ｓ
潲	氵冃Ｓ
鲥	鱼日寸Ｓ
铵	钅宀女Ａ
舨	舟又Ｂ
羼	尸羊羊Ｃ
笪	日一Ｄ
酚	酉八刀Ｆ
刿	山夕刂Ｇ
曷	日勹乚Ｈ
溷	氵囗豕Ｈ
骱	骨人<齐下>Ｊ
胬	女又内Ｎ
俜	亻由丂Ｐ
銎	工几金Ｑ
诎	讠凵山Ｑ
枘	木内ＲＩ
镡	钅覀十Ｃ
粜	凵山米Ｔ
浯	氵五口Ｗ
绁	纟世ＸＥ
崦	山大乚Ｙ
劓	自丌刂Ｙ
蓣	艹<予下>页Ｙ
菝	艹扌犮Ｂ
鐾	尸辛金Ｂ
蛏	虫又土Ｃ
汆	丿丶水Ｃ
甙	弋廿一Ｄ
蒽	艹囗心Ｅ
绋	纟弓<齐下>Ｆ
岣	山勹口Ｇ
崮	山囗古Ｇ
岵	山古ＨＵ
掎	扌大可Ｊ
挢	扌丿<齐下>Ｊ
讵	讠匚<右框>Ｊ
窭	穴米女Ｊ
赉	未丷贝Ｌ
掊	扌立口Ｐ
芟	艹殳ＳＮ
毹	亼<前下>毛Ｓ
锶	钅田心Ｓ
慝	匚艹心Ｎ
氽	人水ＴＮ
芄	艹九丶Ｗ
怿	忄又<举下>Ｙ
鹆	八<谷下>鸟Ｙ
瘵	疒<祭上>示Ｚ
啶	口宀<足下>Ｄ
蔸	艹白儿Ｄ
砘	石七凵Ｄ
罟	罒古ＧＵ
蚶	虫廿一Ｈ
鲎	<学上>鱼ＨＵ
锾	钅爫又Ｈ
湔	氵<首上><前下>Ｊ
搛	扌<首上><兼末>Ｊ
柃	木今丶Ｌ
逯	<录上>水辶Ｌ
亓	二<齐下>ＱＩ
屺	山己ＱＩ
郄	乂阝Ｑ
檎	木人冂Ｑ
毵	厶彡毛Ｓ
渖	氵宀丨Ｓ
肟	月二<亏下>Ｗ
饩	饣气ＸＩ
躞	火又Ｘ
谮	讠旡日Ｚ
酯	酉匕日Ｚ
塍	月土Ｃ
擐	扌罒<衣下>Ｈ
蠖	虫艹又Ｈ
觖	用夬Ｊ
跬	圭ＫＩ
氇	毛鱼日Ｌ
嘧	口宀山Ｍ
蝻	虫<南上><首上>Ｎ
湓	氵八皿Ｐ
氆	毛<首上>业Ｐ
庥	广亻木Ｘ
嵫	山<首上>幺Ｚ
撙	扌酋寸Ｚ
褊	衤户冊Ｂ
篼	白儿Ｄ
鳜	鱼厂欠Ｇ
劢	丆力Ｍ
蛴	虫文<齐下>Ｑ
汔	氵乙Ｑ
骀	马厶口Ｄ
醣	酉广口Ｔ
腽	月日皿Ｗ
舾	舟西ＸＩ
仡	亻乙Ｇ
莸	艹犭尢Ｙ
黼	业巾甫Ｆ
袼	衤各ＧＥ
缑	纟<候角>矢Ｇ
笱	勹口Ｇ
袷	衤亼口Ｊ
肼	月井ＪＧ
僦	亻尢丶Ｊ
蒉	艹<贵上>贝Ｋ
阃	门囗木Ｋ
臁	月广<兼末>Ｌ
倮	亻日木Ｌ
芈	丨一<举下>Ｍ
杪	木少ＭＯ
蠛	虫艹戊Ｍ
蛲	虫<尧上>儿Ｎ
硗	石<尧上>儿Ｑ
跫	工几足Ｑ
荽	艹爫女Ｓ
渫	氵世木Ｘ
崾	山覀女Ｙ
瘗	疒夫土Ｙ
箦	贝Ｚ
舳	舟由ＺＵ
黪	黑厶彡Ｃ
锸	钅千臼Ｃ
瓞	瓜失ＤＥ
滏	氵父<首上>Ｆ
戆	音夂心Ｇ
遘	<冓上>冂辶Ｇ
簋	艮皿Ｇ
鹪	隹灬鸟Ｊ
扃	户冂口Ｊ
篥	覀木Ｌ
鞔	革<见下>Ｍ
浼	氵<见下>Ｍ
庀	广匕ＰＩ
肷	月欠ＱＮ
鲭	鱼月Ｑ
埽	土彐巾Ｓ
钽	钅日一Ｔ
酴	酉亼朩Ｔ
溆	氵亼又Ｘ
钸	钅巾Ｂ
髑	骨罒勹Ｄ
鳆	鱼夂Ｆ
黉	<学上>八Ｈ
逭	宀<官下>辶Ｈ
浍	氵人云Ｈ
裥	衤门日Ｊ
榘	矢匚木Ｊ
犋	牜<具上>八Ｊ
钌	钅乛亅Ｌ
躐	巛<鼠下>Ｌ
砻	龙石ＬＧ
苤	艹不一Ｐ
榀	木口吅Ｐ
钋	钅卜ＰＯ
綮	户攵小Ｑ
胂	月日丨Ｓ
锼	钅叟ＳＵ
炱	厶口火Ｔ
疃	田立里Ｔ
煺	火艮辶Ｔ
鼯	臼<鼠下>口Ｗ
籼	米山ＸＮ
芗	艹<乡上>丿Ｘ
儇	亻罒<衣下>Ｘ
砟	石乍ＺＡ
肫	月七凵Ｚ
秕	禾比ＢＩ
踣	立口Ｂ
帱	巾<丰变>寸Ｃ
氡	气夂<冬下>Ｄ
垌	土冂一Ｄ
佴	亻耳ＥＲ
糇	米<候角>矢Ｈ
肀	<秉中>丨ＹＵ
澌	氵其斤Ｓ
耜	耒<官下>ＳＩ
龆	止凵口Ｔ
禊	礻刀大Ｘ
溴	氵自大Ｘ
氩	气亚ＹＡ
吲	口弓丨Ｙ
岜	山巴ＢＡ
惝	忄冂Ｃ
蝽	虫日Ｃ
腠	月大Ｃ
徂	彳且ＣＵ
硐	石冂一Ｄ
镉	钅一冂Ｇ
虼	虫乙Ｇ
烀	火丿丨Ｈ
蟪	虫士心Ｈ
桷	木用Ｊ
坜	土厂力Ｌ
瞵	目米<舛右>Ｌ
簏	<鹿上>比Ｌ
镘	钅日又Ｍ
擗	扌尸辛Ｐ
筇	工阝Ｑ
畋	田攵ＴＮ
葶	艹<亮上>丁Ｔ
沲	氵也Ｄ
穸	穴夕ＸＩ
眢	夕目Ｙ
搌	扌尸<辰下>Ｚ
埴	土十<具上>Ｚ
陬	阝耳又Ｚ
砹	石艹乂Ａ
畀	田丌ＢＩ
鹁	十子鸟Ｂ
觇	占见ＣＮ
瘅	疒丷十Ｄ
菪	艹宀石Ｄ
铞	钅口巾Ｄ
锇	钅手戈Ｅ
钫	钅方ＦＧ
砉	丰石ＨＡ
锪	钅勹心Ｈ
哜	口文<齐下>Ｊ
锔	钅尸Ｊ
膦	月米<舛右>Ｌ
螨	虫艹两Ｍ
茆	艹<卯左>卩Ｍ
埤	土卑ＢＩ
铈	钅亠巾Ｓ
裼	衤日勹Ｔ
迕	午辶ＷＵ
氙	气山ＸＮ
楦	木宀一Ｘ
蛘	虫羊ＹＧ
镱	钅音心Ｙ
霪	<雨头>氵壬Ｙ
畛	田人彡Ｚ
碡	石母Ｚ
缵	纟贝Ｚ
锿	钅<享上><衣下>Ａ
襞	尸辛<衣下>Ｂ
髟	镸彡ＢＯ
蒇	艹戊贝Ｃ
冁	丷十<辰下>Ｃ
籴	丿丶米Ｄ
揲	扌世木Ｄ
镦	钅<享上>攵Ｄ
苊	艹厂Ｅ
疳	疒廿一Ｇ
茛	艹艮ＧＮ
鳇	鱼白王Ｈ
攉	扌<雨头>隹Ｈ
虮	虫几ＪＩ
镓	钅宀豕Ｊ
噍	口隹灬Ｊ
弪	弓<经角>工Ｊ
胩	月<卓上>下Ｋ
罱	罒<南上><首上>Ｌ
苈	艹厂力Ｌ
蠊	虫广<兼末>Ｌ
埝	土今心Ｎ
钕	钅女ＮＵ
羟	<经角>工Ｑ
羰	山火Ｔ
轺	<车旁>刀口Ｙ
舴	舟乍ＺＥ
潴	氵犭者Ｚ
萆	艹卑ＢＩ
晡	日甫ＢＵ
爨	<臼裂>冂火Ｃ
榱	木亠<衣下>Ｃ
铥	钅千厶Ｄ
鸫	<东上>小鸟Ｄ
胨	月<东上>小Ｄ
罘	罒不ＦＵ
槔	木白十Ｇ
鹱	鸟艹又Ｈ
墼	車殳土Ｊ
骒	马日木Ｋ
悃	忄囗木Ｋ
漤	氵林女Ｌ
稂	禾丶艮Ｌ
诔	讠耒ＬＩ
鲡	鱼一冂Ｌ
疬	疒厂力Ｌ
钔	钅门ＭＮ
淠	氵田丌Ｐ
裒	亠臼<衣下>Ｐ
缲	纟口木Ｓ
薷	艹<雨头><而下>Ｒ
埏	土丿廴Ｓ
谂	讠今心Ｓ
鲦	鱼夂朩Ｔ
莛	艹壬廴Ｔ
榍	木尸冃Ｘ
髹	镸亻木Ｘ
砑	石一<牙下>Ｙ
垸	土宀元Ｙ
帙	巾失ＺＩ
窀	穴七凵Ｚ
浞	氵足ＺＯ
褙	衤匕冃Ｂ
苄	艹亠卜Ｂ
骣	马尸子Ｃ
舡	舟工ＣＮ
岽	山<东上>小Ｄ
赙	贝甫寸Ｆ
漶	氵口心Ｈ
跽	己心Ｊ
疖	疒<节下>ＪＥ
腈	月月Ｊ
桕	木臼ＪＵ
桊	木ＪＮ
埒	土爫寸Ｌ
镅	钅<声下>目Ｍ
镎	钅亼手Ｎ
哌	口<辰下>Ｐ
郫	卑阝ＰＩ
锖	钅月Ｑ
畎	田大丶Ｑ
悫	士冖心Ｑ
颥	<雨头><而下>页Ｒ
唼	口立女Ｓ
钐	钅彡ＳＮ
矧	矢弓丨Ｓ
牾	牜五口Ｗ
鹇	门木鸟Ｘ
殪	歹士<首上>Ｙ
鳙	鱼广冃Ｙ
饔	亠<乡上>食Ｙ
籀	扌田Ｚ
鄹	耳乑阝Ｚ
坌	八刀土Ｂ
荸	艹十子Ｂ
艚	舟<曹上>日Ｃ
觌	十头见Ｄ
铫	钅<兆左><兆右>Ｄ
鲼	鱼十贝Ｆ
澉	氵乛攵Ｇ
哿	加可ＧＥ
瘊	疒亻矢Ｈ
骺	骨<后上>口Ｈ
豇	一<首上>工Ｊ
筘	扌口Ｋ
硇	石<囱框>乂Ｎ
聍	耳宀丁Ｎ
蜱	虫卑ＰＩ
丿	丿ＰＥ丿
氍	目隹毛Ｑ
酞	酉大丶Ｔ
钍	钅土ＴＵ
沩	氵<冬下>力Ｗ
洫	氵丿皿Ｘ
珧	王<兆左><兆右>Ｙ
舁	臼廾ＹＵ
瀹	氵亼冊Ｙ
粢	冫欠米Ｚ
鲅	鱼犮ＢＡ
鞴	革<甬下>Ｂ
窆	穴丿之Ｂ
瘛	疒丰心Ｃ
镄	钅弓贝Ｆ
祓	礻犮ＦＵ
恝	丰刀心Ｊ
瘕	疒<右框>又Ｊ
戋	一戈ＪＮ
鲒	鱼吉ＪＥ
醵	酉虍豕Ｊ
瘼	疒莫ＭＯ
铌	钅尸匕Ｎ
脬	月爫子Ｐ
葜	艹丰大Ｑ
椠	<车旁>斤木Ｑ
瞍	目叟ＳＵ
羧	厶夂Ｓ
粞	米西ＸＩ
蓰	艹彳<足下>Ｘ
窬	穴亼<前下>Ｙ
哳	口扌斤Ｚ
轵	<车旁>口八Ｚ
忮	忄十又Ｚ
埯	土大乚Ａ
聱	敖耳ＡＯ
礤	石艹示Ｃ
搋	扌几Ｃ
憝	<享上>攵心Ｄ
钆	钅乚ＧＡ
艽	艹九ＪＯ
鳘	攵鱼Ｍ
恧	丆<而下>心Ｎ
襻	衤木手Ｐ
氕	气丿ＰＥ
镨	钅<首上>日Ｐ
铷	钅女口Ｒ
洳	氵女口Ｒ
蟓	虫象ＸＧ
鸺	亻木鸟Ｘ
铕	钅冃Ｙ
驵	马且ＺＧ
迮	乍辶ＺＥ
廒	广敖ＡＯ
濞	氵自丌Ｂ
嶝	山癶<首上>Ｄ
耵	耳丁ＤＧ
蹯	丿田Ｆ
篚	匚非Ｆ
嚆	口艹<高外>Ｈ
劐	艹又刂Ｈ
鲚	鱼文<齐下>Ｊ
鲣	鱼又土Ｊ
趼	开ＪＮ
赆	贝尺<冬下>Ｊ
爝	火爫寸Ｊ
钶	钅可ＫＥ
鳢	鱼日<首上>Ｌ
荬	艹乛头Ｍ
镤	钅业丶Ｐ
桤	木山己Ｑ
筲	冃Ｓ
堍	土兔ＴＵ
箨	扌<举下>Ｔ
蕹	艹丿隹Ｗ
钇	钅乙ＹＩ
罾	罒丷日Ｚ
橥	犭者木Ｚ
鲻	鱼巛田Ｚ
阼	阝乍ＺＯ
揞	扌音ＡＮ
庳	广卑ＢＩ
馇	饣木一Ｃ
怊	忄刀口Ｃ
脞	月从土Ｃ
埭	土彐水Ｄ
塥	土一冂Ｇ
绠	纟一乂Ｇ
蕻	艹厶八Ｈ
鲩	鱼宀元Ｈ
癀	疒八Ｈ
洎	氵自ＪＩ
礓	石一一Ｊ
捃	扌<秉中>口Ｊ
锎	钅门开Ｋ
轹	<车旁><卬左>小Ｌ
跞	<卬左>小Ｌ
瞀	攵目Ｍ
猸	犭<声下>目Ｍ
鹛	<声下>目鸟Ｍ
脒	月米ＭＩ
耱	耒广石Ｍ
衄	丿皿丑Ｎ
甓	尸辛瓦Ｐ
锓	钅彐又Ｑ
脎	月乂朩Ｓ
滠	氵耳又Ｓ
鲐	鱼厶口Ｔ
萜	艹巾占Ｔ
砼	石人工Ｔ
涠	氵囗二Ｗ
甾	巛田ＺＩ
痄	疒乍ＺＡ
浈	氵<卓上>贝Ｚ
瘃	疒豕丶Ｚ
舭	舟比ＢＩ
螬	虫<曹上>日Ｃ
躔	广土Ｃ
枨	木长ＣＧ
眵	目夕夕Ｃ
镩	钅穴丨Ｃ
垡	亻戈土Ｆ
稃	禾爫子Ｆ
郛	爫子阝Ｆ
酤	酉古ＧＵ
崞	山<享上>子Ｇ
蜾	虫日木Ｇ
捍	扌日干Ｈ
谫	讠<首上>刀Ｊ
眍	目匚乂Ｋ
癃	疒阝Ｌ
毪	毛厶牛Ｍ
仫	亻丿厶Ｍ
垴	土文凵Ｎ
筢	扌巴Ｐ
锫	钅立口Ｐ
螵	虫覀示Ｐ
岍	山开ＱＮ
阢	阝一儿Ｗ
菥	艹木斤Ｘ
鼷	臼<鼠下>大Ｘ
薤	艹歹一Ｘ
舣	舟丶乂Ｙ
著	艹者ＺＵ
腙	月宀示Ｚ
蒡	艹<旁上>方Ｂ
鹎	卑鸟ＢＩ
滗	氵毛Ｂ
缏	纟亻丈Ｂ
醭	酉业丶Ｂ
猹	犭木一Ｃ
瘥	疒工Ｃ
膪	月<旁上>口Ｃ
阽	阝占ＤＮ
簖	乚斤Ｄ
牿	牜口Ｇ
馘	<首上>自戈Ｇ
撖	扌乛攵Ｈ
缋	纟<贵上>贝Ｈ
牮	代牛ＪＮ
铼	钅未丷Ｌ
铹	钅艹力Ｌ
泐	氵阝力Ｌ
墚	土刀木Ｌ
镥	钅鱼日Ｌ
苠	艹巳七Ｍ
脲	月尸水Ｎ
蒎	<艹氵><辰下>Ｐ
犏	牜户冊Ｐ
钷	钅匚口Ｐ
劁	隹灬刂Ｑ
鼽	自丌九Ｑ
磉	石又木Ｓ
鲺	鱼乙丿Ｓ
贳	世贝ＳＩ
摅	扌虍心Ｓ
耥	耒冂Ｔ
螗	虫广口Ｔ
箢	夕Ｙ
軎	車口ＷＩ
莶	艹亼<应下>Ｘ
痃	疒玄ＸＮ
痖	疒亚ＹＡ
疰	疒主ＺＵ
碥	石户冊Ｂ
瘭	疒覀示Ｂ
傺	亻<祭上>示Ｃ
鼢	臼<鼠下>刀Ｆ
瀵	氵米八Ｆ
艴	弓<齐下>巴Ｆ
戤	乃皿戈Ｇ
筻	一乂Ｇ
觏	<冓上>冂见Ｇ
鲴	鱼囗古Ｇ
轷	<车旁>丿丨Ｈ
耠	耒亼口Ｈ
茳	<艹氵>工ＪＧ
喹	口大圭Ｋ
醌	酉日比Ｋ
蒗	<艹氵>丶艮Ｌ
铑	钅耂匕Ｌ
耢	耒艹力Ｌ
蔹	艹<应下>攵Ｌ
稆	禾口口Ｌ
攴	<卓上>又ＰＯ
苘	艹冂口Ｑ
赇	贝<求架>丶Ｑ
辁	<车旁>人王Ｑ
赕	贝火火Ｄ
铽	钅弋心Ｔ
猃	犭亼<应下>Ｘ
糈	米乛冃Ｘ
酏	酉也ＹＩ
茚	艹<印左>卩Ｙ
齄	自丌一Ｚ
绗	纟彳亍Ｈ
荮	艹纟寸Ｚ
夼	大川ＫＧ
螋	虫叟ＳＵ
耖	耒少ＣＯ
蒈	艹比白Ｋ
鲕	鱼丆<而下>Ｅ
禚	礻灬Ｚ
鳋	鱼又虫Ｓ
啰	口罒夕Ｌ
瞭	目大小Ｌ
珅	王日丨Ｓ
