的	db
一	yt
了	lv
是	sb
不	bg
我	wj
这	zw
在	zp
人	ri
有	yr
他	ti
来	lg
个	gi
道	dk
你	ni
大	dd
到	dt
着	ze
就	ju
上	sy
们	mi
那	nn
也	yc
说	su
么	mr
下	xf
出	cc
然	rn
地	df
中	zo
看	kj
时	sbi
要	yq
没	mv
天	tt
过	gj
可	kje
自	zr
子	zd
能	nv
还	hg
之	zz
以	yd
去	qf
好	hx
后	hf
为	wk
都	dfe
会	hi
里	le
心	xc
得	ddbu
对	dx
身	ss
手	sj
起	qz
小	xv
想	xg
只	zoi
而	vt
和	ht
头	tk
她	tx
无	wf
力	l;
面	mt
己	jc
如	rx
现	xe
什	si
样	yg
多	dn
已	yca
知	zdu
些	xz
经	js
声	sp
前	qk
神	spbo
笑	xk
事	sjo
开	kt
点	dz
方	f;
眼	yqi
发	fw
所	sr
但	di
气	q;
法	fv
意	yu
情	qy
两	lq
生	sru
家	ja
间	jn
将	jk
很	hd
真	zy
话	hu
成	cl
让	ru
被	bp
老	lf
动	du
当	dm
用	ym
于	yf
见	jai
回	hq
又	yx
军	jno
把	bj
此	cz
才	cj
几	jnu
战	zzni
正	zt
龙	lx
明	mb
从	ci
却	qfve
长	ck
十	sye
三	sv
女	nx
光	gm
再	zee
向	xb
实	sa
最	zb
行	xd
高	gu
本	bge
打	dj
定	da
进	jh
魔	mrgo
风	fn
给	gs
问	wn
国	gq
色	s;
同	tn
种	zto
走	zze
其	qh
年	niu
口	ko
王	we
怎	zs
边	b;
次	cko
全	qe
白	bb
吧	bo
儿	va
感	gl
果	gb
听	to
啊	vo
体	tigu
外	wnu
死	se
飞	fz
分	fa
主	zu
觉	jm
住	zi
少	svi
比	bl
空	ka
因	yqia
门	mn
等	dkfu
轻	ql
直	zye
第	dkgu
候	hipu
脸	ln
相	xge
强	qg
何	hiu
张	zg
快	ky
做	ziyu
重	zf
与	ys
太	td
应	yro
刚	gn
接	jj
位	wi
便	bi
量	lb
更	gx
难	nxa
名	mnu
二	vg
内	nii
连	ll
水	sk
西	xq
黑	h;
马	mm
部	bu
入	rr
作	ziu
吗	mo
兵	br
师	sh
虽	sc
别	bw
击	jf
放	f;o
完	wa
四	sq
灵	lea
公	ga
并	bk
先	xfu
处	cw
士	sf
剑	jamu
算	skqu
东	dl
机	jg
微	wd
城	cf
火	hw
变	bm
叫	jo
清	qv
带	dmne
杀	sx
斯	she
李	lge
队	dp
云	yue
者	zfe
望	wc
原	yrbe
竟	jy
像	xi
惊	jyu
呢	no
安	vano
山	sw
星	xbri
族	zzo
海	hv
月	yn
加	jw
金	je
目	mq
特	tf
跟	gz
场	cfje
林	lgei
由	yb
万	wt
美	me
任	riu
使	sixu
日	rb
立	lu
命	ma
思	sbia
关	gk
百	bt
转	zl
理	lee
常	cm
血	xr
乎	hr
受	sm
离	lw
该	guo
界	jb
远	ya
平	pf
阵	zpa
物	wfsu
冷	lk
数	skxo
信	xiu
刻	kd
至	ztve
突	ta
失	sd
怪	gy
随	spra
五	wee
反	ff
找	zj
似	siu
许	xu
般	bd
武	wtle
雷	lm
非	fe
奇	qd
通	ts
解	j;
绝	js;a
怕	py
精	jko
修	xiwu
暗	vb
满	mvho
双	sxa
度	dr
且	qhi
红	hs
半	bf
世	sl
始	sxva
倒	ditu
拉	lj
今	ji
它	tao
落	lp
攻	g;
学	xm
尔	v;
传	cigu
音	yuo
指	zjle
路	lz
越	yz
表	be
石	st
容	ra
紧	jhxi
哥	gje
合	ha
罗	lqi
利	lt
冲	ckoo
步	bz
够	gso
影	ybvi
姐	jx
伤	sii
若	rh
亲	qq
功	g;e
整	zgwe
弟	dkgo
丝	sssa
息	xrqu
吃	co
众	zii
花	hh
势	sz
早	zbi
哈	ho
帝	d;
流	lvco
团	tq
青	qqe
根	gg
极	jge
静	jq
形	xt
即	jr
深	sva
周	zn
近	jru
千	qfu
消	xvmo
结	jsa
制	zfnu
干	gf
帮	bepe
速	sg
楚	cg
性	xy
备	bwu
系	xrsu
言	yuoe
提	tj
教	jfde
皇	hb
令	li
文	ww
雪	xme
谁	suo
终	zswa
必	bc
站	zuo
化	hiui
哪	noni
破	pt
认	ruo
忙	my
往	wdu
玉	ye
级	jsaa
车	cle
底	drco
总	zk
坐	ziiu
巨	jce
男	nb
显	xbi
克	kye
各	gw
新	xqo
斗	dko
仙	xiui
急	j;e
切	qle
阳	yp
叶	yo
领	lisu
收	sya
衣	ypo
敢	gv
异	ycae
围	wq
达	dde
象	x;
件	jiu
错	clhu
服	fnpu
慢	mybo
保	bio
办	b;a
活	hvo
喜	xo
片	pk
杨	ygje
兴	xmo
刀	d;a
摇	yj
准	zko
夜	yui
拿	na
电	dbi
交	juo
条	tw
朝	cy
华	hilu
管	gka
断	dklo
兽	skbo
决	jkoe
尽	jca
苦	kh
依	yi
易	ybsi
八	ba
则	zm
露	lmze
语	yueo
兰	lko
闪	sn
冰	bko
足	zzi
记	juoa
德	ddyu
响	xobi
害	hae
及	jju
球	qeke
阿	vp
计	juoa
顿	dlu
爱	vai
告	go
夫	fd
七	qlea
嘴	zoli
器	qo
圣	sxao
南	nm
留	lc
元	yae
敌	ds
沉	cv
请	qu
官	gao
威	wl
每	miu
况	kk
确	qt
答	dka
乱	ls
陈	cp
宝	bae
视	spo
护	hj
格	gge
脑	nnwu
兄	xoi
狂	kdu
淡	dv
识	suoo
题	tb
停	tinu
司	sjta
低	dicu
雨	yme
呼	hori
久	j;u
未	wg
孩	hda
卫	wp
脚	jnfu
除	cpa
古	gye
亚	yw
字	za
骑	qm
房	fp
代	dlui
伙	hiui
鬼	gba
员	yoi
缓	hsma
复	fi
六	luo
黄	hhbe
装	zkfo
居	jp
凌	lkfo
呵	hoi
米	mk
恐	k;
单	dkbo
旁	p;
钱	qltu
跑	pz
布	bre
或	hl
爷	yau
玩	weee
报	bjpe
疑	yl
术	sge
睛	jqi
隐	yp;a
欢	hxa
续	xs
章	zyo
差	ce
挥	hjne
父	fau
句	jsu
待	ddfu
九	jz
派	pv
持	cjfe
类	lkou
宇	yao
丽	ltne
蓝	lh
佛	figu
刘	lwo
忽	hsdu
怀	hy
您	ni;u
怒	nxxa
掉	djye
招	zje
希	xx
送	skdo
背	bkli
工	g;ei
甚	shei
烈	lehe
卡	kyi
细	xsa
掌	zmi
论	lui
密	maco
运	yuee
退	tr
酒	jv
求	qke
猛	md
另	lwi
射	ssu
集	jqu
首	skro
北	bki
照	zb;i
晚	wb
赶	gze
守	sao
木	mg
散	shne
穿	ca
联	lhke
铁	tl
段	de
练	lsla
喝	hobi
需	xmte
支	zyei
巴	bca
左	zre
陆	lpfa
角	j;ua
书	svpa
防	fpa
忍	r;
莫	mde
群	qera
民	mc
客	kao
线	xsta
毫	hn
肯	kz
展	zpha
谢	xuso
亮	lno
痛	trso
股	gnu
造	zou
妖	yxra
虎	hp
秦	qde
紫	zzli
宫	gaoo
激	jvbo
赵	zzei
渐	jvlo
震	zmre
注	zv
禁	jgei
吸	xoia
取	qhe
梦	mge
枪	qge
程	ct
叹	toi
江	jvo
简	jknu
羽	yja
友	yre
继	jska
念	nivu
右	yreu
萧	xh
热	rz
份	fiu
乐	lcu
压	yrfe
既	jra
靠	kou
香	xtu
恶	vw
引	yga
止	zzie
包	bpu
追	zc
仅	jiui
寒	haho
雅	ytje
争	z;
愿	yrbe
超	cze
狠	hdu
厉	lr
式	sle
波	bv
刺	cgne
号	hoia
态	tdu
存	cpe
游	yv
台	tv
跳	tz
狼	ld
属	spra
妹	mx
炼	lwlo
灭	mte
英	yh
醒	xqbe
举	jma
嘿	hoia
境	jfe
胜	snru
诉	suro
抱	bje
毕	ble
务	wwu
甲	jbi
齐	qw
拍	pj
唐	tre
君	jera
楼	lgke
险	xp
院	ypa
建	jefa
观	gxa
柔	rs
逃	tkku
置	zq
娘	nxu
担	djbe
殿	dpha
阴	ypai
呆	do
层	cpae
试	sulo
约	yssa
凡	fnu
眉	mp
弹	tg
救	jku
银	ylu
统	tsca
否	fg
索	syne
抓	zjei
府	fr
调	tu
曾	ckbo
魂	hube
基	jhe
顶	dje
峰	fwwi
苏	sh;e
图	tqwi
松	sga
议	yuu
料	lkou
顾	gr
严	ywe
业	ywi
恩	vq
礼	lpo
耳	vh
选	xfa
余	yy
败	bmi
区	qc
顺	smu
皮	px
沙	svo
瞬	sqmi
树	sgxe
秘	mtcu
商	suoe
组	zsa
块	kf
汉	hvoo
充	cco
贵	gc
迷	mko
混	hvbo
纷	fs
示	spe
伸	sibu
娜	nxna
助	zh
呀	yoti
封	fge
排	pje
期	qhei
肉	rii
船	cd
座	zri
义	yuou
舰	jd
闻	wno
升	srue
室	sato
妈	mxa
亡	wco
付	fiui
控	kja
警	jhwe
负	f;u
推	tje
扬	yjje
模	mgei
芒	mh
凤	fnua
虚	xpi
默	m;
土	tfe
技	jjye
费	fgha
温	wv
市	suoe
麻	mro
初	cpo
考	kfe
拥	yje
究	jao
握	wjpe
资	zki
普	pkwo
翻	frbu
察	caa
独	ddu
幸	xfke
舞	winu
称	ct;u
玄	xso
母	mba
暴	bbhi
按	vj
孙	sda
睡	sqfi
改	gca
换	hj;e
素	sese
较	jl
具	jhi
箭	jkku
品	po
忘	wcoe
状	zkdo
堂	tm
副	ffe
承	cvka
野	yesi
锋	fl
洞	dvno
遇	ybni
查	cgbe
洛	lvo
局	jpja
赛	saho
划	hle
权	qgei
藏	ch
味	wo
丹	dnu
故	gyei
钟	zlo
坏	hfe
仍	riui
宗	zao
弱	rg
弄	ne
脱	tnku
菲	fh
胸	xn
哼	hou
药	yhse
历	lre
徐	xdu
拳	qj
爆	bwbo
杰	jgei
谈	tuwo
须	xvu
坚	jhxi
奥	vbku
仿	fiui
据	jjpe
偷	tia
施	szo
产	cu
营	yno
骨	gai
晶	jbbi
透	tt;u
尊	zkou
短	ddtu
抬	tjve
政	ztze
烦	fwo
河	hvoo
牙	yte
维	ws
证	zuto
卷	jjo
幽	ywsi
草	chbe
森	sgei
吴	woti
摆	bjqe
蒙	mnge
危	w;
毒	dee
投	tjei
熟	suzo
飘	pq
导	dc
朋	pn
质	zryu
释	srku
喊	holi
胡	hye
参	cvda
休	xiui
劲	jx;a
景	jbu
挡	djme
印	yeu
惜	xyho
枫	fgei
幻	hsa
欲	ywu
摸	mj
烟	ywqo
致	ztfe
州	zmo
冥	mnbo
尼	np
抗	kju
妙	mxau
翼	yjba
秋	qtu
凝	nk
寻	xea
盘	pd
永	yuoa
板	bgei
智	zdo
哦	voji
责	zeee
尸	spa
傲	vi
柳	lgge
御	ydi
临	lhki
浪	lvu
辈	bei
娇	jxra
恨	hyo
吓	xoia
价	jii
硬	ytxe
探	tja
际	jpa
横	hghe
标	bgei
纳	ns
欧	vc
宁	nj
墙	qfye
田	tbi
习	xj
肩	jpo
戏	xxa
奈	nd
设	suoa
效	xua
福	fpo
袋	dlui
移	ytnu
型	xthe
疯	fro
毛	mz
贝	bmia
冒	mbi
叔	syvi
碎	stu
轰	hlxe
扑	pjei
奋	fde
饭	f;ua
科	ktu
惨	cyvo
咱	zori
治	zvvo
湖	hvyo
环	he
尘	cvi
略	lbi
躲	dsnu
免	m;o
盟	mbni
珠	zeee
迎	ycpu
凭	pi
规	gd
犹	ydzu
雄	xrve
距	jzci
伯	biu
借	jihu
域	yfle
床	cr
骂	moo
莉	lhte
朱	zgu
史	so
避	bpua
聚	jhxe
皱	z;e
秀	xtue
韩	hyye
挑	tjke
降	xpwa
敬	jho
源	yvro
徒	tduu
束	sgei
鲜	x;u
撞	zju
岁	swi
架	jwa
嘛	mori
哭	koo
袭	xxe
惑	hlo
罪	zqi
节	jhei
罢	bq
食	s;u
啦	lo
唯	woi
买	mva
训	xuo
腿	tnru
稍	stmu
校	xgu
艾	vhe
诺	nu
某	mhte
邪	xtje
鲁	l;u
姑	gxau
阻	zpai
丁	djei
塔	tfhe
闭	bn
迅	xzya
逸	y;
臣	ccye
残	cete
裂	lehe
托	tjre
良	luoa
泪	lvoo
尖	jvi
晓	xbli
伊	yie
洋	yvo
屋	wpta
尚	smi
颗	kb
鱼	y;u
炸	zwo
仇	qi
讲	juoa
焰	yw;o
配	pqe
旧	jyi
绿	lse
假	jipu
圆	yqo
验	yma
番	pr
搞	gjei
迹	jmo
荡	tp
彩	cmgu
腾	tnju
恢	hyro
腰	ynqu
厅	treu
牛	nf
吼	hodi
占	zznie
颤	cuto
趣	qzhe
梅	mgi
奔	bdye
臂	bpua
愣	ly
勇	ysma
套	tde
剩	stku
志	zfei
舒	sayu
端	duwo
虑	lpi
医	yce
妮	nxpa
炮	pw
蛋	dvza
卖	myve
闹	nnu
颜	yuro
归	gh
圈	jqji
限	xpa
浮	fvmo
弃	qco
适	ssue
软	rl
抵	djce
厚	hrbe
帅	shi
尤	yze
讶	yuto
广	gro
范	fpe
桌	zybi
欣	xru
病	brto
共	ghe
职	zho
诸	zuoa
镇	zlyu
专	zge
值	ziyu
偏	pipu
杂	zzu
增	zfke
豪	hno
咬	you
触	c;
陷	xp;a
雾	wm
挺	tjee
炎	ywo
稳	wt;u
择	zjxe
巧	q;e
胖	pnu
附	fpi
盯	dq
碰	ptke
纪	jsaa
阶	jpi
谷	ywuo
嗯	voqi
岛	dsu
夏	xtqe
扫	sje
潜	qvdo
毁	he;u
项	x;e
旋	xzvo
抢	qje
抽	cje
优	yizu
迪	dbia
涌	yvso
网	wnxi
祖	zpo
拜	bjtu
测	cvmo
伟	wigu
案	vanoo
列	leeu
谓	wu
操	cjo
春	cde
店	dro
瑞	re
善	seko
逼	bfe
浑	hvno
输	sla
烧	swlo
瞪	dqa
慕	mdei
懂	dy
富	fao
汗	hvoo
侧	zimu
赤	cfe
率	luso
杯	bgei
京	juoe
吉	joe
滚	gvpo
曼	mbqi
浩	hvoo
获	hhde
轮	lli
损	sjoe
抖	djei
累	lbsi
讨	tuo
苍	che
悄	qymo
养	yeuo
塞	saho
鸣	moi
挂	gjei
胆	dnbu
孤	gda
傻	sibu
陪	pp
镜	jlu
凶	xxu
吐	toia
杜	dg
猜	cdu
庞	pro
幕	mdei
琳	leee
蛇	sca
拼	pjke
孔	kda
盖	ge
材	cge
扎	zjei
爸	bau
预	ysja
晃	hbmi
闷	mno
姓	xxra
莱	lhge
仔	ziui
吟	yoii
遍	bpqo
彻	cdlu
纯	cs
伦	lii
盗	dki
愤	fy
困	kq
缘	yse
纵	zsi
啸	xoe
夺	ddeu
壁	bpua
宋	saoo
估	giu
介	jiuo
画	htbe
庄	zro
狗	gdsu
沈	cvmo
贼	zmli
补	bpo
摩	mrgo
脉	mnuu
泰	tdee
痕	hro
燕	yho
折	zjei
劫	jfve
演	yva
灰	hre
伏	fidu
悠	yiwu
婆	pvxo
创	ciu
研	ytte
含	hivu
写	xno
凯	kw
岳	yru
午	wfu
池	cvo
睁	zq;i
萨	shpe
暂	zlre
闲	xnoi
概	ggre
逐	zeeu
旦	dbia
登	data
误	wuo
戒	jle
村	cgei
街	jdgu
跃	yzri
牌	pku
廷	te
罩	zqyi
斩	zle
班	behe
爵	jmru
陛	bpla
膀	pn;u
迟	cca
踪	zza
替	tdde
谋	mu
伴	biui
霸	bmfe
傅	fimu
怜	lyi
乌	wsu
曲	qb
瞧	qqi
惧	jyho
俊	jivu
歌	gjje
咒	zoo
漂	pvqo
嘻	xoo
倍	biuu
采	cmu
昨	zbia
互	hte
鹰	yri
蒂	dh
舍	sau
慌	hyho
糊	hk
犯	fdu
扭	nje
判	pfo
丢	dftu
羞	xeo
昏	hc
竹	zku
唤	ho;i
忧	yyzo
锐	rlku
琴	qee
宽	kaho
莲	lhle
躯	qs
郎	luro
疼	trwo
席	xrho
伍	wiu
剧	jpya
碧	bebe
征	zdtu
鸟	nsu
赞	zffu
丈	zx
侍	sifu
悉	xrku
漫	mvbo
缩	ssa
帐	zmia
遭	zqbe
坦	tfbe
喃	nomi
悟	wy
壮	zkoe
辰	cre
貌	mdbu
鼻	brqu
聊	lhge
怨	yncu
弓	gga
绕	rsla
私	stue
耀	ymai
财	cmi
掩	yjde
吞	ttde
织	zso
监	jhki
洗	xvfo
佩	pinu
融	rt
插	cjfe
梁	lv;o
忠	zoyi
悲	beie
笔	bku
迫	pb
凉	lku
丫	yk
鼓	goke
豫	ysja
亦	ymo
敏	mibu
狱	yddu
召	s;a
佣	yiu
忆	yyo
朵	dnua
博	by
狐	hdua
吹	coi
拔	bjei
荣	rne
劳	lne
茶	chi
缠	csra
盛	clje
磨	mrgo
浓	nvmo
净	jk;o
仰	yicu
遥	ymfu
废	froe
恭	gha
菜	chme
阁	gno
缺	qfue
粗	ckou
躺	tsu
宣	xa
桑	sxxa
绍	ssaa
惯	gybo
遗	yci
晕	ybni
执	zziei
喷	poyi
刹	sxgu
努	nxxa
脆	cn
轩	xl
佳	jiui
耗	hge
窗	cabo
积	jt
策	ckgu
辉	hm
灯	dw
辛	xuoe
援	yjme
堆	dfei
扶	fj
踏	tzki
库	kr
屁	ppa
唇	crre
奴	nxau
翔	xeou
熊	xvla
粉	fk
勒	lfe
尾	ypae
批	pjei
乖	gfku
艳	ye;e
趁	czi
慧	hee
姬	jxca
爬	pm
隆	lpwa
怖	byro
赏	smio
晨	cb
刃	r;a
媚	mxpa
耐	nt
拖	tji
丰	fee
码	mteu
诚	culo
律	lde
乃	n;
赫	hfme
曹	cq
岂	kwi
固	gqi
洁	jvoo
盾	dryu
社	spoa
郭	gudo
骗	pmpa
滑	gvo
霄	xmme
隔	gp
纸	zsca
戴	dyle
额	vawo
惹	rhre
撤	cjce
荒	hhce
季	jtu
延	yrzu
痴	crdo
锁	slmu
旗	qzo
撒	sjhe
郁	yrne
典	dnhi
颇	pxa
侯	hipu
园	yqia
振	zjre
仪	yiuu
省	xvi
猎	ldhu
殊	see
绪	xsaa
跪	gz;i
玛	mee
抚	fjfe
油	yvoo
委	wtu
纹	wsa
泉	qbu
滴	dvo
洪	hvho
启	qp
供	gihu
忌	jcae
拦	ljke
祭	zau
妻	qye
贴	tmi
妇	fx
庆	qr
擦	cja
币	bru
婚	hxca
牢	la
仁	riui
甘	ghei
奶	nxau
径	jdxu
倾	qilu
符	fki
赌	dmi
钻	zlu
蛮	mmo
矮	vd
唉	vovi
堡	pio
馆	g;a
宜	yaoo
姿	zkio
爽	sdxe
堪	kfhe
焦	jjui
劈	ppu
零	lmi
薄	bpme
扰	rj
艘	sdu
耶	yhe
牧	mf
益	yka
朗	luro
挣	zj;e
递	dkgo
匆	csdu
肖	xmi
婷	txna
亏	kg
袍	ppo
燃	rw
扯	cjei
叛	pfou
胁	xn;u
拒	jjce
肚	dnua
皆	jlea
柱	zgei
墨	m;i
董	dhfe
砸	ztce
莎	spei
液	yvu
辆	lle
途	ty
岩	ywia
芳	fhe
慰	wpja
户	hpo
烂	lwko
欺	qhei
针	zlue
砍	kte
筑	zk;u
醉	zqu
扔	rje
洲	zvo
协	xy;e
驾	jwau
享	xuoe
漠	mvo
巫	w;i
莹	yne
撑	cjme
郑	zkdo
眨	zqri
赢	yco
恼	ny
珍	zei
虫	cci
康	kre
椅	ygde
俩	liu
旅	lzro
货	hilu
减	jklo
尝	cmio
盈	y;xa
愧	kybo
邦	bee
骇	hma
餐	cyxi
埋	mfe
瑟	sece
抛	pjze
吻	wosi
敲	quyo
猫	mdhu
侵	qie
弯	wmo
茫	mpe
悔	hyi
喘	cowi
穴	xao
玲	lei
勾	gsu
哎	vohi
截	jyle
舌	ssue
肃	sea
牵	qdne
例	lie
庭	treo
彼	bdu
宙	zaoo
氏	scu
夹	jde
霜	smge
仗	ziui
济	jvwo
吕	loi
渊	yvho
卓	zybi
甜	tshu
笼	lkue
柄	bgte
嘉	joke
诡	gu;o
姆	mxau
脖	bnyu
爹	danu
霍	hme
抹	mje
艺	yhei
倩	qiu
秒	mtu
昂	vbci
踢	tzbi
哀	vpo
末	mgee
奉	fdee
劝	qx
腹	fni
钢	glnu
宏	haro
爪	zmu
挤	jjwe
泽	zvxo
鸿	hv;o
核	hgei
侠	xidu
猪	zdua
疾	jro
瓶	pkho
僵	jitu
乘	stku
寂	javo
粮	lkuo
聪	chke
诱	yuto
懒	lygo
搭	djhe
潮	cvyo
鹏	pnnu
魏	wtxu
咐	fo
鸡	jxa
肤	fnua
薇	wh
弥	mg;a
瓦	wwe
央	ydia
勉	m;a
川	cmui
屈	qpa
耸	siiu
匹	pc
尺	ccae
喂	wobi
丧	syke
悍	hybo
悬	xhvi
拾	sja
晴	qbi
亿	yiui
讯	xuzo
溜	lv;o
魄	pbbu
帕	pmi
括	kjei
孟	mda
乔	qrdu
怔	zyto
蕾	lhme
搜	sjei
诗	sufo
偶	vibu
均	jfse
童	tuoe
覆	fq
厌	yrde
悦	yyko
载	zyle
掠	lju
垂	cfu
琪	qeee
泄	xvo
霞	xmye
港	gvho
袁	yfo
臭	xrqu
衡	hd;u
构	ggse
肌	jnua
词	cujo
纤	xsaa
票	pqei
诀	juoa
饰	s;i
噬	soki
宠	cao
脏	znru
袖	xpo
键	jleu
穷	qa
泥	nvpo
驻	zma
眸	mqvi
航	hduu
辞	csu
乡	xsaa
催	ciwu
宿	xai
慎	syyo
魅	mbau
撕	sjhe
逆	nkwo
凑	ckdo
缝	fswa
歉	qkmo
授	sjei
甩	snu
映	ybi
岸	vwri
凰	hnbu
唱	cobi
奸	jxau
陵	lpfa
崇	cwa
枚	mgei
读	duyo
暖	nbmi
扩	kjei
狮	sdtu
瑶	yeme
沿	yvno
渡	dvro
稀	xtxu
搂	ljke
恋	lmo
捏	njbe
饶	r;lu
吩	foi
笨	bkgu
返	ffnu
赖	lgo
斥	cru
贤	xhxi
煞	s;wu
询	xuso
斜	xyu
撼	hjle
眯	mqi
铺	pl
咳	hoia
浅	jvto
尬	gzi
尴	gzhe
齿	czii
洒	svoo
督	dyxi
奖	jkno
卑	bbi
染	rv
促	ciui
弗	fga
娅	yxa
麽	mrgo
泛	fvro
契	qe;e
酷	kqe
罚	fqu
络	lsa
埃	vf
课	ku
屠	tpa
祸	hpoo
汇	hvoo
疗	lrvo
赐	cmbi
刑	xthe
夸	kdge
雕	dnfu
检	jga
祥	xpoa
俗	siui
俱	jihu
摔	sju
屏	bpka
麦	meee
闯	cno
予	ysa
矿	kteu
恒	hyto
郡	jera
呜	woia
疲	proe
迈	mtje
寸	cjei
详	xuoa
亭	tno
巡	xma
滋	zvko
葛	ghse
婴	ymmi
录	leae
涛	tve
冠	gna
枝	zgye
翅	cyxe
窜	caoo
昆	kbi
婉	wx
妃	fxa
矛	ms
蝶	dcli
瘦	sro
编	bs
俏	qimu
贪	tivu
繁	fiwu
绵	msba
棋	qgei
斧	fauo
裹	gpbo
姜	jeo
氛	f;ue
後	hdsu
乾	qyye
拨	bjei
慈	ckso
瞒	mqhi
嫣	yxta
咕	goi
屑	xpma
铃	lliu
辱	rrre
雀	qvi
冯	pko
允	yvao
樱	ygme
愈	yahu
宾	bao
晰	xbgi
掏	tjse
措	cjhe
啪	poji
誓	sjre
农	nmo
糟	zkqo
驶	smo
捉	zjei
祝	zpoo
朕	znku
咯	loia
扮	bjei
淫	yvmo
鼠	seu
畏	wbi
羊	yeo
驱	qmca
恰	qya
璃	lewe
芙	fhei
烁	swco
岚	lwia
梯	tgke
裁	cyle
韵	yubo
咽	yoqi
辕	ylfe
夕	xnu
涯	yvro
卢	lyie
碍	vtbe
幅	fm
扇	spoa
愕	vy
芸	yhei
哇	woia
润	rvno
崩	bwni
县	xhi
杖	zgei
汤	svjo
翠	cju
健	jie
箱	xkgu
恍	hymo
骷	kai
捕	bjei
育	ycoe
猴	hdpu
遮	zrho
泡	pvo
麟	lrko
扣	kjei
鼎	dqki
溃	kv
娃	wxa
髅	laki
逍	xmni
述	sgu
豹	bdsu
评	pu
献	xmde
涂	tvo
序	xrso
铜	tlnu
饮	y;ua
灾	zaoo
湿	svbo
冬	dwu
贫	pa
汹	xvxo
党	dmio
棒	bgde
贯	gbaa
串	coo
丛	cii
昌	cbi
棍	ggbe
嫁	jxaa
弘	hga
肥	fnua
穆	mtbu
挖	wja
阔	kn
跌	dzi
丑	cba
赚	zmki
披	pjei
漆	qvgo
奏	zdte
贺	hwa
喉	hopi
酸	sqve
捷	jjte
卧	wcye
凄	qkyo
割	gaoo
违	wgpe
役	ydu
坛	tfei
砰	ptfe
筋	jknu
裸	lpbo
井	jhee
涨	zvgo
沐	mvoo
仓	ciuo
巍	wwxi
宴	yabo
饿	v;ju
鞭	bfi
馨	xpne
瓜	gmu
骚	smxa
匪	fc
耻	chei
妄	wcoe
肆	seve
宛	wano
裤	kp
蠢	cdce
龟	g;bu
妥	tmu
霆	tme
雯	wme
吵	coia
驰	cma
嫩	nxga
审	sabo
戈	gle
款	kfpe
桥	qgre
诧	cua
晌	sbbi
勃	byde
搬	bjde
仆	piu
漏	lvpo
械	xgle
彭	poke
盔	krwe
灌	gvho
桃	tgke
黛	dlui
黎	ltsu
饱	b;u
欠	qiua
抑	yjce
疆	jgfa
嘶	sohi
辣	lugo
纠	jsaa
签	qka
购	gmsi
镖	blqu
揉	rjse
愚	ybni
勤	qhee
誉	ymao
鄙	boqi
衫	spoa
珊	seee
弩	nxxa
呈	coia
腕	wna
怡	yyvo
坠	zpi
腥	xnbu
培	pfu
牲	sfru
窝	wao
障	zpai
锦	jlbu
蓉	rnei
拢	lje
瞳	tqu
麒	qrlo
析	xgei
脾	pnua
涩	sv;o
蓦	mdei
铠	kl
嘲	zoyi
毅	yueo
僧	siku
尉	yppa
寺	sfe
链	lllu
邀	ybwu
企	qiuo
蜜	maco
骤	zmxa
趴	pzi
频	pzvi
挨	vjve
蒋	jhke
卿	qgru
植	zgye
刷	spma
厂	creu
歪	wgte
嚣	xooi
琼	qeu
耍	stqe
龄	lzu
拟	njei
崖	ywri
寨	zaho
伐	fiui
丘	qru
柯	kge
磊	ltte
晋	jwe
艰	jxao
竞	juoo
碗	wta
慨	kyro
涉	svzo
艇	tdeu
谨	juho
荷	hhi
跨	kzdi
浴	yvoo
舱	cduu
颠	dya
趟	tze
盒	hao
撇	pjke
骄	jmra
逊	xdva
坑	kfu
柜	ggce
摧	cjwe
崔	cwi
幼	ysaa
愁	ctwu
仑	liuo
姨	yxda
踩	czmi
谅	luu
坤	kfbe
绑	bse
锤	clfu
哑	yoia
贾	gqe
宰	zaoo
乳	rm
陌	mpta
惠	hfbe
竖	shxi
销	xlmu
叮	doi
访	fu
虹	jci
绽	zsaa
沾	zvoo
添	tvto
沃	wvro
挽	wj;e
迦	jwau
舟	zduu
堵	dfei
鹿	lro
纱	ssaa
巾	jmi
荆	jhhe
薛	xhce
绩	jse
捂	wje
枯	kgei
腐	fri
兔	t;
凛	lkuo
夷	yde
梵	fgne
哗	holi
绳	sso
靖	juoe
搏	bjme
斌	bwto
颈	jx;a
筹	cke
逝	sjre
厨	crte
辅	fle
逗	dto
藤	th
盼	pqi
咦	yodi
尹	yea
呃	vori
芬	fhei
狸	ldu
矩	jdcu
憾	hylo
膝	xngu
雁	yrie
胳	gnua
咧	loe
沌	dvlo
於	y;i
墓	mdei
畅	cbyi
擅	sjue
冻	dklo
摊	tjxe
黯	v;u
泣	qvo
楞	lgqe
叉	cx
籍	jkgu
牺	xfue
敖	vae
哄	hohi
铭	ml
霉	mmi
躬	gsui
淋	lvoo
膊	bnmu
嫌	xxka
歇	xbli
捧	pjde
痒	yroe
塌	tfbe
嚷	ro
涵	hvvo
旨	zlua
灿	cwo
摄	sjhe
削	xmni
茵	yhqe
嘟	dofi
匕	blu
膛	tnmu
拱	gjhe
肢	znyu
眠	mqci
珑	leee
伪	wiku
斤	jruu
逛	gde
惶	hybo
励	lrte
儒	rimu
陡	dpa
仲	zio
瞄	mqhi
哨	somi
羡	xeko
掀	xjre
辽	lvja
沟	gvso
墅	sesi
汽	qvoo
档	dgme
隶	leae
描	mjhe
俘	fimu
蜂	fcwi
呐	noi
哲	zjre
卒	cui
赔	pmu
裙	qpe
哮	xofi
寿	seee
攀	pg
杆	ggei
旺	wbia
寇	kaa
吾	weei
篮	lkhu
狄	ddua
储	ciuu
鉴	jhki
嘀	doia
虏	lpie
嚎	honi
赋	fmti
隙	xpva
炉	lwou
呻	sobi
殷	yreu
污	wvgo
辩	buu
篇	pkpu
嗓	soxi
吊	doia
播	bjre
颊	jdke
偿	cimu
冤	ynoa
耿	ghei
俯	firu
俄	viju
躁	zzoi
狞	ndu
嗔	coyi
廖	lrjo
罕	haoa
狡	jdu
溅	jvmo
蹲	dzki
焕	hw;o
缕	lska
嘎	goti
烤	kwfo
渴	kvbo
篷	pkwu
乏	fru
擒	qji
棠	tmio
粒	lkou
祺	qpo
惩	cdtu
患	hoo
谦	quko
汪	wvo
押	yjei
辨	buho
蛛	zci
歹	deeu
蕴	yhse
沸	fvgo
遣	qcci
陶	tpsa
迁	qfue
版	bkui
咆	poi
彷	pdu
囊	nyo
劣	lvi
芝	zhe
潇	xvho
鳞	l;ku
甫	fme
逢	fwe
玫	meee
狈	bdua
邓	dxa
侦	ziyu
炽	cwoo
竭	jubo
讽	fuo
挠	njle
拓	tjei
戮	ljva
订	duo
苟	ghse
娶	qhxe
蔡	cha
丸	wz
佐	ziru
宅	zaro
厢	xrge
驳	bmxa
拐	gjei
昭	zbia
弦	xga
淑	svyo
叠	dxxa
俞	yauo
辜	gyei
兼	jke
吱	zoyi
腻	nnlu
础	cte
兮	xau
琉	lece
蓬	ph
厮	srhe
坡	pfe
咪	moia
朴	pge
妍	yxta
胎	tnvu
刮	gsue
苗	mhe
廊	lru
遵	zkjo
蜀	sqsi
倭	witu
浸	jve
滞	zvmo
梭	sgve
湾	wvmo
韦	wge
玻	beee
禀	buqo
茹	rhxe
敛	lamu
澜	lvno
聂	nh
疏	svza
瞎	xqa
豆	dtoe
溢	yvko
犬	qdeu
廉	lrko
潘	pvro
嗦	soyi
祈	qpoa
灼	zwso
瞥	pkwo
斑	bewe
顽	wae
兹	zkso
糕	gke
昊	hbti
锅	glo
缚	fsma
妞	nxau
匠	jceu
魁	kba
鹤	hnqo
绯	fsa
谎	huho
榜	pg;e
碌	lte
拂	fjge
壶	hfne
昧	mbia
遁	dryu
蔽	bh
庙	mroe
蹄	tz;i
茜	qhei
腔	qn
堕	dpra
耽	dhme
硕	ste
壳	qfne
彪	bpni
肠	cnju
钰	yle
岭	lwii
嗡	woa
栋	dgle
葬	zhee
冉	rni
挪	njne
鞋	xfe
蹦	bzwi
柴	czli
蔓	mhbe
陀	tpaa
姊	zxra
啧	zoe
妨	fxau
窃	qalo
阎	yn;o
盆	pau
焚	fgei
矢	sdue
携	xjqe
钉	dlue
帘	lao
俺	vidu
嗤	cowi
萝	lhqe
沧	cvoo
循	xdru
搅	jjme
渺	mvqo
兀	wte
狭	xddu
戟	jyye
申	sbia
翘	qla
嘱	zopi
拆	cjre
津	jveo
贱	jmti
汝	rvo
暇	xbpi
愉	yya
侄	zitu
棵	kgbe
谭	tuqo
轨	glea
蚁	ycu
啥	soa
媒	mxha
噗	powi
锻	dle
赴	fze
诈	zuoa
巢	cmba
捡	jja
哟	yosi
衷	zpoo
吁	yoia
彦	yuro
渗	svvo
峡	xw
涡	wvoo
禅	spko
氓	mcco
浆	jkno
租	ztu
阅	ynko
掐	qj;e
帽	mmbi
揭	jjbe
妒	dxau
毙	blee
寞	mao
孝	xfei
乙	zzaa
贸	mc;u
革	gfe
喔	wopi
憋	bkwo
蓄	xhse
坎	kfei
舅	jebu
絮	xxo
烛	zwou
歆	xubo
胞	bnu
翰	hyye
颖	yltu
彤	tnu
唔	woe
垃	lfei
圾	jfei
尧	ylte
旭	xzu
寄	jado
喀	koa
遂	ske
阱	jpai
泊	bvo
妾	quo
瑰	gebe
虐	npi
潭	tvqo
祀	spoa
逻	lqni
璇	xeze
税	stku
嫂	sxau
填	tfye
蛟	jcu
怯	qyfo
滔	tvmo
弧	hgae
惫	bwbu
煌	hwbo
雍	yuro
衍	ydvu
笛	dku
庸	yreo
兆	zkuo
咚	dowi
暮	mdei
卜	byi
裳	cmio
沫	mvoo
蝎	xcbi
寡	gato
蚀	s;ua
枉	wgei
粹	cku
澡	zvoo
昔	xhe
摘	zjei
瀚	hvi
寝	qako
熙	xcce
舜	smnu
售	squ
栽	zyle
胧	lnu
贞	zyi
诅	zuoa
滩	tvxo
韧	rgpe
倚	yidu
睹	dqi
栈	zgte
蝠	fci
桶	tgse
卦	ggei
臀	tpna
狰	zd;u
姚	yxka
雇	gpo
署	sqi
狙	jdua
泼	pvoo
诛	zuoa
朦	mnnu
栏	lgke
筒	tknu
哧	cofi
溪	xvmo
册	chu
窥	kado
湘	xvgo
犀	xpka
舔	tstu
剥	beka
磁	ctke
惕	tybo
旷	kbia
佑	yiru
歼	jee
兜	dcpu
窟	kapo
枕	zgme
囚	qqia
裴	pe
胀	znu
楠	ng
觑	qpwi
擂	ljme
拽	zjbe
捣	djse
蕊	rhce
巷	xha
乞	qiue
谱	puko
蚩	cwta
哩	loia
琢	zeee
垒	lvva
胃	wbia
虞	ypoi
绣	xsta
衰	cpoe
扁	ppoa
菩	phu
颅	lypi
骆	lma
抄	cjei
菁	jhei
纽	nsa
贡	g;ei
噢	vobi
桓	hgte
绮	qsda
戚	qlye
惟	wyo
慑	syho
罡	gqti
喧	xoa
衙	ydeu
瑜	yeae
岗	gwni
侃	ki
祷	dpe
萍	ppfe
剂	jwho
莽	mhde
诞	duro
轴	zlea
嘘	xopi
烫	tvjo
咙	loia
鞘	qfme
丞	cvka
剿	jmga
孽	nhce
淘	tvso
翎	lisu
翁	wavu
恕	sxo
衬	cpoa
倦	jiju
揽	ljke
疚	jr;o
轿	jlre
秃	ttu
猾	hdua
钦	qlu
嗜	sofi
掷	zjke
藉	jhge
鸦	ytje
陨	ypoa
熬	vaee
窍	qa;o
郝	hfme
芷	zhei
咖	koi
勋	xomi
铸	zleu
叨	toia
乍	zsu
磕	ktfe
扳	pjei
霎	smue
姥	mxfa
棺	ggae
奢	sde
辟	ppoa
叙	xyuo
畜	xsoe
嫉	jxra
蜘	zcdi
搁	gjne
钥	ylue
陋	lpta
茅	mhse
倏	siwu
瘫	trxo
菊	jhse
匙	cbzi
翩	ppqo
倘	tiu
擎	qhwe
趋	qz;e
窄	zaoo
峻	jwvi
啡	foia
嗽	sogi
醋	cqhe
酥	sqe
伺	siju
恳	kra
粘	nko
哆	doni
绞	jsua
绷	bsna
丐	gt
渠	qvco
娱	yxo
佘	siuo
淌	tvoo
履	lpda
塑	skno
症	zrto
衔	xdlu
蔑	mhqe
禽	qiwu
傀	kibu
蛊	gci
炀	ywjo
捞	ljne
蒸	zhve
缄	jsla
嗖	soi
炫	xwo
眩	xqi
歧	qzyi
邱	qrui
挟	xjde
帆	fmni
莺	ynei
渔	yvoo
敞	cmio
绰	csya
淳	cvu
厥	jrke
瞟	pqqi
霹	pmpe
疤	bro
柏	bgei
徽	hdws
讪	suoa
猿	ydfu
沮	jvoo
眶	kqci
页	yieu
卸	xizu
宵	xamo
惭	cylo
菱	lhfe
踹	czwi
肿	zno
萱	xnte
斐	fei
钩	glsu
瓷	cki
雳	lmre
茂	mhei
肺	fntu
届	jpae
鹫	juu
碑	bte
儡	libu
蝉	ccki
夭	yrue
娟	jxo
曰	ybia
淮	hvoo
拘	jjse
搓	cjee
捅	tjse
豁	haoo
亨	huvo
荐	jhpe
漩	xvzo
捆	kjqe
沼	zvoo
迭	ddue
侮	wii
叱	coia
槐	hgbe
迸	bkho
扛	gjei
屡	lpka
鲍	b;ua
脊	jkko
忖	cyo
婢	bx
栗	lqe
驼	tma
贩	fmi
芦	lhe
拎	lji
彬	bgei
姗	sxau
淹	yvdo
怠	dvoa
钧	jlsu
嗅	xori
樊	fgge
弛	cga
霓	nme
揍	zjde
喽	loki
汁	zvoo
惮	dyko
邻	lisu
蟒	mchi
衅	xrqu
瘾	yrpo
账	zmia
览	lhki
妩	wxfa
厦	xrte
妆	zkoe
芊	qhei
抿	mjce
喻	yoa
吏	lxe
澈	cvco
砖	ztge
僻	pipu
倪	nie
挫	cji
杏	xgei
襄	xpoo
桐	tgne
矣	yvao
噩	ve
揪	jjte
拧	njei
燥	zwoo
郊	jua
喇	logi
沦	lvio
蚂	mci
阮	rp
帖	tmia
戬	jwbe
铲	clu
孕	y;a
跺	dzni
巅	dwa
敦	dudo
婪	lgei
蹈	dzmi
蹭	czki
株	zgei
凹	vu
婿	xxva
嬉	xxoa
盐	yfye
冀	jkli
膜	mnua
剪	jkho
鞠	jfse
桂	ggei
盏	ztle
襟	jpgo
逞	coe
棘	jgne
焉	ytse
跋	bzi
呕	voci
稚	ztue
嵌	kwhi
熠	ywjo
颓	ttnu
妓	jxya
穹	qao
邵	s;au
涣	hv;o
债	zie
梧	wgee
勿	wsua
墟	xfpe
焱	ywwo
桩	zgre
脯	fnua
镶	xlpu
拭	sjle
忿	fauo
撩	ljde
涟	lvlo
谍	dulo
拇	mjei
瑾	jehe
疫	yroe
掘	jjpe
梨	lthu
窒	zato
朽	xgei
奕	ymoe
涅	nvbo
顷	qlea
咋	zoia
酬	cqe
琦	qede
蝙	bcpi
吭	koui
僚	lidu
镰	llru
砚	yteu
瞅	cqti
饥	j;ua
邸	dclu
漾	yve
婕	jxta
胤	yasu
呸	pogi
译	yuxo
峙	zwfi
寥	lajo
凸	tti
垫	dzie
肋	lnua
噜	lo;i
漓	lvwo
剔	tbdi
猩	xdbu
梳	sgce
峨	vwji
熄	xwro
睿	ry
禹	yrcu
址	zfei
蝴	hcyi
萌	mhbe
瞻	zq;i
眷	jjou
蹬	dza
绘	hsi
龚	gxhe
岔	cau
唬	hopi
飙	bdde
驭	ymaa
漪	yvdo
侥	jilu
肘	znua
侣	lio
熏	xfue
螺	lcbi
聘	phbe
唾	tofi
幢	cmui
揣	cjwe
坊	ffei
湛	zvho
谊	yua
箫	xke
沛	pvto
垮	kfde
妲	dxba
鹃	joni
翡	feie
琐	seme
髓	sari
讥	juoa
裕	ypoa
薪	xhqe
毯	tzwu
骸	hai
癸	gata
苹	phfe
匿	nc
脂	znlu
玑	jeee
澎	pvoo
枢	sgce
懈	xy;o
宪	xafo
搀	cj;e
皓	hbu
悸	jyto
嗷	voi
跄	qzi
镯	zlqu
膨	pno
憨	hvwa
瓣	bumo
泻	xvno
踉	lzui
黝	y;si
葫	hhye
渣	zvgo
麾	hrgo
酿	nq
詹	z;ru
沁	qvoo
眈	dqmi
畔	pbi
懊	vybo
熔	rwa
筷	kkyu
霖	lme
综	zsaa
傍	bi;u
瑕	xepe
刁	dja
嚓	coa
惚	hyso
践	jzti
兢	jya
尿	spae
秉	btu
伞	siku
崆	kwa
棉	mgbe
媳	xxra
坟	ffei
鹅	vjlu
瀑	bvbo
鲸	j;uu
逮	deka
糖	tkro
缉	qso
稻	dtmu
暧	vbi
奎	kde
绸	csna
隋	spra
狩	sdau
湃	pvto
叽	joi
饼	b;ku
靡	mrgo
锥	zlue
碟	dtle
拙	zjei
簇	ckzu
蝇	ycoi
蚕	ctde
叩	koia
咸	xlte
亢	kuo
澄	dva
骏	jmva
辖	xla
媛	yxma
姻	yxqa
扒	pjei
赠	zmki
秩	ztue
朔	skwo
倔	jipu
嚼	jomi
卵	lgku
胶	jnuu
绚	xssa
镔	bla
蚊	wci
唧	jori
炯	jwno
罐	gfhu
浊	zvoo
冶	ykvo
讳	hugo
杭	hgu
弊	bkwo
戳	cjqa
禄	lpe
斋	zwto
搐	cjse
炙	znua
佬	lifu
聋	lxeu
厄	vr
凳	data
鲨	svvo
驴	lmaa
盲	mco
锢	glqu
锡	xlbu
诏	zuoa
伽	jiui
铮	zl;u
缭	lsda
鸭	ybia
捶	cjfe
唰	sopi
搔	sjxe
滥	lvko
恙	yeou
谜	muko
啃	kozi
啼	to;i
驯	xmaa
匣	xce
悯	myno
鸾	lmoe
杉	sgei
煜	ywbo
拣	jjle
拯	zjve
偎	wibu
呛	qoi
绅	ssba
屿	ywia
煮	zfei
璐	leze
冈	gni
甄	zqfe
匈	xsxu
钓	dlsu
咔	koyi
笙	skru
桀	jnyu
蜥	xcgi
囔	noyi
缴	jsba
喳	cogi
泳	yvuo
睬	cqmi
祟	scai
崎	qwdi
谣	yumo
晖	hbni
炭	twri
忑	tfei
栖	qgei
娴	xxna
忐	tyti
榕	rga
堤	dfbe
哽	goxi
烬	jwco
炒	cwou
棱	lgfe
肝	gnua
靴	xfi
痞	prgo
阀	fnio
缪	msja
赦	sfme
殖	zeye
纲	gsna
璧	bpua
厘	lreu
泓	hvgo
涕	tvko
壤	rf
懿	yfke
闺	gnoi
浇	jvlo
匀	ysu
棚	pgne
娲	wxo
蔚	yhpe
稽	qtuu
虾	xci
劭	s;au
茨	chke
戾	lpdo
橙	cgae
厕	crme
捐	jjoe
瘟	wr
舵	dda
芯	xhei
晒	sbia
烙	lwou
驸	fmia
亵	xpoe
颂	savu
钝	dllu
窘	jaro
懦	nymo
稷	jtbu
赎	smyi
袅	nsua
庶	srho
腮	snbu
绢	jso
葱	chse
溶	rva
榻	tgbe
吨	doli
貂	dduo
哉	zyle
娥	vx
悚	sygo
虔	qpi
蹙	clye
婶	sxaa
屎	spae
磋	ctee
殆	deve
诩	xuoa
蠕	rc
偌	rihu
拚	pjve
骼	gaia
觅	mmu
旱	hbi
裔	ypno
昱	ybia
冕	mb;i
屯	zlea
惋	wya
萎	whte
苑	yhne
枭	xsu
惺	xybo
砂	steu
殴	vcxe
叭	boi
梢	sgme
缨	ysma
蹿	cza
飓	jnhu
峭	qwmi
甸	dsua
谐	xulo
澳	vv
聆	lhi
腊	lnhu
缜	zsya
帜	zmoi
昼	zcba
滕	tnju
茧	jhei
绫	lsfa
汰	tvdo
皙	xgre
踱	dzri
嵩	swia
兑	dkoo
诊	zui
葡	phse
筝	zk;u
邃	sako
辑	jlo
獠	lddu
昕	xbia
蜡	lchi
奄	ydbe
诵	suso
腑	fnru
悻	xyfo
憎	zyko
嗨	hoii
敷	fm;e
庇	broe
榴	lg;e
晦	hbii
祢	mp;o
荀	xhse
慷	kyro
寓	yabo
茉	mhei
咄	doia
曙	sbqi
噪	zooi
吒	zori
缸	gfu
幡	fmri
啤	poia
烨	ywlo
忡	cyoo
粥	ygka
悴	cyu
咏	youi
颔	hio
洽	qva
募	mdei
驿	ymxa
藩	fpre
靶	bfei
谬	mujo
憔	qyo
邹	z;eu
痹	brbo
绊	bsa
酋	qko
框	kgce
茄	jhei
挚	zziei
萄	thse
恬	tyo
聿	yeae
檀	tgu
凿	zwki
璋	zeee
钞	clue
褐	hpbo
蟹	x;;u
鬟	heqe
铛	dlmu
曦	xbe
崽	zwbi
胯	kndu
璀	cewe
菇	ghxe
眺	tqki
瘩	drho
璨	cexe
抡	ljie
斟	zhle
褪	tpro
涎	xvro
勺	ssua
溟	mvno
疙	gri
坪	pffe
猥	wdbu
塘	tfre
揖	yjo
逾	yahu
冽	lke
遏	vbsi
芽	yhte
裘	qku
徊	hdqu
函	hvka
槽	cgqe
蟾	cc;i
睫	jqti
珂	ke
嘭	poo
蒲	ppe
煎	jkho
庚	gre
荫	yhpe
稿	gtu
徘	pduu
蛙	wcia
睽	kqa
廓	kru
滨	bva
彰	zyoe
锵	qlnu
掺	sjve
缰	jsta
芭	bhe
嗒	tohi
嘈	coqi
暄	xba
琅	leu
萤	ynei
旬	xsua
翱	vbyu
栅	sgei
缈	msqa
猝	cduu
魇	yrde
攒	zjfe
蜴	ycbi
鞑	dfde
窿	lapo
扈	hpoo
蜷	qcji
秽	htwu
崛	jwpi
谕	yuao
袱	fpdo
瑚	heye
磅	bt;e
缔	ds;a
攸	yiyu
缥	ps
惬	qyco
撅	jjre
钮	nl
阙	qnko
鸽	gaou
葵	kha
曳	ybli
蔼	vhu
礁	jte
苛	khe
佗	tiau
庐	lroe
珀	pee
稠	ctnu
娉	pxba
嗣	soqi
饵	v;ua
耕	ggee
肴	yxru
渎	dvyo
嵋	mw
伶	liiu
瑭	tere
懵	myho
饷	x;bu
韬	tgpe
恃	syfo
浦	pvoo
邢	xthe
咻	xoii
隧	spka
贷	dlui
滢	yvno
掳	ljpe
颁	bauo
芜	whfe
檐	yg;e
祯	zpyo
吝	lwoe
蘑	mhre
咫	zco
茬	chpe
怦	pyfo
缀	csxa
扼	vjre
唠	loni
趾	zzia
殃	yee
噼	popi
掂	djre
啐	cou
羌	qeo
畴	cbe
枷	jgei
捺	njde
禾	htu
绒	rsla
邮	ybia
辙	clce
籁	lkgu
煽	swpo
戎	rle
糙	ckoo
漱	svgo
竿	gku
瘪	brro
矫	jdru
汀	tvoo
吆	yoia
怅	cyoo
攘	rjpe
叼	doji
昵	nbpi
烽	fwwo
猖	cdbu
芥	jhie
紊	wwso
甬	ysao
跷	qzli
靓	lqee
栩	xgei
簌	skgu
寐	mako
壕	hfne
侈	cinu
嫡	dxau
黏	ntku
亩	muo
酣	hqhe
舆	yelu
痊	qro
娆	rxla
侏	ziui
佯	yiui
锣	llqu
佼	jiuu
羲	xeso
棣	dge
鳄	v;o
惘	wyno
霏	fmeo
媲	pxba
蔷	qhye
篝	gkhu
蛤	hca
虬	qci
荧	ynei
舷	xduu
螂	lcui
溺	nvgo
羿	yjao
巳	scae
仕	siui
攥	zjke
桦	hgle
氧	y;ue
殇	sei
捻	nji
胄	zbia
臧	zlle
萦	ynse
漉	lvro
骋	cmba
券	qjo
贬	bmri
瑛	yehe
迂	yfe
晟	sbli
雏	c;e
勘	khle
煤	mwho
坞	wfe
衮	gpa
蓓	bhi
蹂	rzsi
蜒	ycri
忒	tle
晏	ybia
牡	mfu
札	zgei
缎	dse
膏	guoe
屹	ywii
肮	vn
哒	dodi
煦	xbsi
棕	zga
糜	mrgo
瞠	cqmi
筱	xki
躏	lzhi
臻	ztfe
淤	yvi
瀛	yvco
蹊	xzmi
孰	sudo
沪	hvoo
浙	zvjo
毗	pbia
呱	goia
磐	pdnu
矜	jsja
幺	ysaa
俨	yiwu
琥	hepe
胴	dnnu
暑	sbia
雌	czli
锯	jlpu
硝	xtme
酱	jkno
喋	doli
箍	gkju
婧	jxau
玺	x;vu
羁	jqfi
骁	xmla
拈	njei
迢	t;a
衲	npo
呗	boia
钵	blgu
鬓	bea
剖	puo
蜿	wca
鞍	vfe
伫	zia
恤	xyro
铿	klxu
鸳	yncu
蝗	hcbi
茸	rhe
赃	zmri
谴	quco
邑	yoia
俐	litu
吮	sovi
刊	kfee
钳	qlhu
亥	hdo
噎	yofi
巩	g;ne
驹	jmsa
薰	xhfe
踌	czei
饕	topi
矗	cyhe
躇	czhi
蹑	nz
弑	sxgu
崭	zwli
褚	zpoa
湮	yvqo
踞	jzpi
恺	kywo
鸠	jzu
邯	hhte
渍	zve
汴	bvu
蜈	wcoi
惦	dyro
谑	xupo
砌	qtle
辎	zlme
贿	hmri
癫	dryo
诫	julo
赘	zae
伎	jiyu
铐	klfu
诣	yulo
匡	kc
岌	jwi
旎	nzpo
锈	xltu
桅	wg;e
鸯	ydia
鲲	k;bu
莞	gne
玮	wege
剌	lgoe
茱	zhei
祁	qpoa
奠	dkou
岱	dlui
辫	buso
闵	mnoi
燎	lwdo
椒	jgye
缇	tsba
惴	zywo
疮	cro
酌	zqse
窖	jaoo
邬	wsua
呦	yosi
顼	xee
岐	qwyi
捋	ljme
飕	snua
楮	cgei
帷	wmi
笃	dkue
噔	doa
骰	tai
鄂	vosi
珏	jeee
汩	gvoo
鑫	xeeu
嘤	yomi
掰	bja
峦	lmoe
冢	zne
瓮	wavu
唏	xoxi
蟆	mcia
掣	cfhu
隘	vpka
瞩	zqpi
茗	mhne
哝	nomi
拷	kjfe
蚣	gcai
慵	yyro
洼	wvoo
牟	mvao
娄	lkou
敝	bkmo
孜	zda
龌	wzu
餮	tei
窦	dayo
烘	hwho
咣	gomi
飒	suoe
咎	jwyu
憧	cyuo
逵	kfa
闽	mnoi
啷	lou
睨	nqe
铅	qlnu
楷	kgle
绎	ysxa
皎	jbuu
龊	czu
阉	yndo
黠	x;i
隼	squi
菌	jhqe
钗	clxu
诶	vuvo
杠	ggei
靥	yrde
饲	s;ju
蜃	srre
筛	skhu
淼	mkki
粪	fkho
颍	ylku
喏	rohi
苔	thve
啬	syke
闸	znoi
憬	jybo
伢	yitu
酝	yqe
柬	jgei
啄	zoei
窑	yaoo
旖	yzdo
喵	mohi
寰	haqo
羔	geo
膳	sne
缅	msta
垣	yfte
筠	ykfu
乒	pru
榨	zgae
笈	jkue
瞑	mqni
剁	dngu
奚	xmsu
兖	yuao
庵	vrdo
瓒	zefe
孺	rd
梓	zgei
杵	cgei
扉	fpoa
诲	hui
坍	tfne
咂	zoci
噤	jogi
峥	zw;i
纶	lsi
壑	hyxi
殉	xese
辐	flea
蜕	tc
唆	sovi
阖	hnfo
谛	du;o
穗	stfu
琶	peee
螳	tcmi
盎	vdi
褒	bpi
贲	byhe
毋	wba
淬	cvuo
藻	zpve
粟	sqei
袜	wpo
佟	tiwu
簸	bkhu
苇	whge
醇	cqu
枣	zgne
拗	njse
椎	cgei
橡	xgei
蹋	tzbi
遐	xppa
拌	bjei
馋	c;;u
橘	jgse
霭	vm
啜	coxi
撮	cjbe
馒	m;bu
纬	wsga
嬴	ycoo
潺	cvpo
筏	fkiu
宦	haco
娑	svvo
鹭	lzwi
玎	deee
抉	jje
匍	psu
蕃	bhre
恻	cymo
乓	prui
苞	bhei
胥	xvza
帛	bbu
驮	dma
痪	hr;o
碾	ntpe
陕	spda
嬷	mxra
髯	rene
嫦	cxma
耷	ddeu
阑	lngo
迳	jx;a
弈	ymoe
眦	zqzi
侬	nimu
娓	wxpa
噘	jori
炬	jwco
沥	lvro
曜	ybji
禧	xpoo
陇	lpa
咛	noia
砾	ltce
竺	zkue
胭	ynqu
涧	jvno
墩	dfu
呲	zozi
篡	ckqu
昙	tbia
蟠	pcri
旌	jzro
睦	mqfi
羹	geto
琵	peee
咀	joia
馅	x;;u
讷	nuo
磷	ltke
孵	fgmu
濒	bvzo
亘	gtbe
簧	hkhu
诬	wu;o
擞	sjke
魃	bba
瓯	vcxe
曝	pbbi
删	shu
徨	hdbu
宓	maco
桨	jkno
楣	mgpe
铎	dlxu
剐	goii
匐	fsu
腆	tnnu
谏	jugo
粼	lkno
阐	cnko
婀	vxpa
邺	ywii
纨	wsza
辗	nlpe
卉	hyei
偃	yicu
鹊	qhbe
槛	kgke
荼	the
锭	dla
瘴	zroe
瑙	neme
皂	zbu
踝	hz
铳	clcu
锄	clhu
剃	tkro
吠	fodi
蛰	zziei
琰	yewe
叟	ssui
缤	bsaa
颌	haou
珈	jeee
浏	lvwo
卤	lyqi
匾	bcpe
飚	bnwu
刨	ppua
杞	qgei
馁	n;mu
瘸	qrwo
榭	xgse
绛	jswa
姒	sxau
殒	yeoe
瓢	pqpe
窈	yaso
栓	sgei
婊	bxe
譬	ppua
谄	cu;o
垠	yfei
壹	yfne
呤	loii
烹	puvo
靳	jfei
丕	pgeu
蕉	jhei
隅	ypba
礴	btpe
嫖	pxqa
炊	cwou
珞	leee
挲	svvo
蛾	vcji
膺	yrio
猬	wdbu
潞	lvzo
筐	kkcu
骜	vaee
俑	yisu
鳌	vaee
稣	s;ua
蒜	shpe
窕	tako
腋	ynu
魑	cbau
芮	rhei
簪	zka
麴	qgwe
黔	q;i
垢	gffe
屉	tpae
馀	y;ua
笋	skeu
轼	slle
汲	jvoo
迥	jnoi
垄	lxeu
弼	bgta
沣	fvo
稼	jta
纣	zsaa
郢	yoe
藐	mhde
寅	yato
戍	sleu
簿	bkvu
拄	zjei
泌	mvco
渲	xva
嚏	toyi
呓	yohi
篆	zke
斓	lwno
鲤	l;ua
熹	xoke
圭	ggei
锏	jlnu
螃	pc;i
茎	jhxe
龇	zzui
丙	btei
皑	vbwu
睚	yqri
撂	ljbe
惆	cyno
鸥	vcxe
嚅	romi
炳	bwto
谧	muco
篱	lkwu
跚	szi
渤	bvyo
螓	qcdi
矶	jteu
梗	ggxe
岑	cwii
槌	cgce
糗	qkro
滤	lvpo
蛆	qcia
拴	sjei
晁	cbki
犷	gdu
潼	tvu
灶	zwou
踵	zzfi
坝	bfei
髻	jeei
嗲	doai
袒	tpbo
晔	ybli
碳	ttwe
麓	lgre
渝	yvao
涔	cvwo
卯	mgu
菡	hhve
泯	mvco
撬	qjze
羚	leio
抠	kjce
嗬	hohi
馈	k;u
骠	bmqa
凋	dkno
赂	lmia
噌	coki
鸨	blyu
苜	mhei
幌	hmbi
褥	rpro
嘹	lodi
袂	mpo
荤	xne
囤	tqli
裆	dpmo
盅	zoyi
醺	xqfe
萃	chue
赧	nfme
婵	cxka
氤	y;qu
腼	mntu
梆	bgee
涸	hvqo
釜	fafu
镭	llmu
椭	tgre
祠	cpjo
硫	ltce
晤	wbe
隗	wpba
痉	jrxo
笺	jktu
饺	j;uu
睐	lqgi
峒	twni
涤	dvwo
俸	fidu
玟	weee
谪	zuoa
渥	wvpo
劾	hdoe
氲	y;bu
挛	lmoe
蹒	pzhi
霈	pmve
舫	fduu
鳅	q;tu
苋	xhei
琬	wea
怏	yyoo
嗫	nohi
瞰	kqvi
蚌	bci
溯	svko
沓	tki
翌	yjao
蜻	qcia
甭	bgeu
唷	yoci
藕	vhge
疵	crzo
啾	joti
绔	ks
毓	yibu
桉	vge
癖	prpo
蝼	lcki
韶	subo
霁	jmwe
蔬	shze
跤	jzui
甥	sre
颐	ycye
怂	siiu
炕	kwu
咿	yoei
咤	zoa
毡	zzue
桔	jgei
鳖	bkwo
弋	ylea
撰	zjce
晾	lbu
泞	nvo
嗝	goti
霾	mmde
蟑	zcia
臌	gnyu
掬	jjse
绾	wsaa
獒	vade
璞	pewe
臊	sno
臾	yeui
恸	tyu
贮	zmai
阂	hnoi
岖	qwci
翟	zja
咨	zkio
堑	qlre
倡	cibu
忏	cyoo
妤	yxsa
啵	bovi
殛	jeve
瞌	kqfi
哐	koci
圃	pqia
蛹	ycsi
俭	jia
灸	j;uu
剽	pqpe
缆	lska
橱	cgre
秤	ctfu
搪	tjre
嗥	hobi
粲	cyxi
钛	tldu
圳	zfei
邕	ymoa
畿	jsla
鹦	ymxi
淀	dvao
褂	gpgo
瘤	lrco
忤	wyoo
笠	lkue
挎	kjde
渭	wvbo
糯	nkmo
祗	zpco
肾	shxi
恿	ysma
垛	dfne
鹉	wtze
纺	fsaa
觎	yahu
觊	jwci
潋	lva
猊	nde
豺	cduo
胚	pngu
魍	wbau
琛	cea
炜	wwgo
揶	yjhe
鬃	zea
汜	svoo
辘	llre
雹	bme
玷	deee
撵	njde
颦	pzii
坳	vfse
杳	yge
荃	qhei
揄	yjae
摁	vjqe
咝	sosi
辄	zlhe
箩	skqu
鹞	ymfu
犸	mdu
捎	sjme
潦	lvdo
蚯	qcia
翊	yuoe
湄	mvpo
芋	yhei
靼	dfbe
濑	lvgo
郸	dkyo
啕	tosi
粱	lv;o
镀	dlru
汐	xvoo
榆	ygae
淇	qvoo
魉	lba
脓	nnmu
苯	bhge
赈	zmri
觐	jhee
坷	kfei
篑	kku
哂	soia
旃	zzno
齑	jweo
荦	lnei
裟	svvo
辇	ndde
幔	mmbi
蘅	hhde
颚	vosi
犄	jfdu
惰	dyro
徙	xdzu
蚓	ycgi
柿	sgue
睥	bqi
讹	vui
嵘	rwni
嗵	tosi
暹	xbqi
悼	dyyo
罔	wnki
琏	lele
蠡	leca
囵	lqii
骊	lmta
堰	yfce
趄	qze
宸	caro
垦	krae
啻	c;mo
趔	lze
魈	xbau
麝	srlo
摒	bjpe
遢	tbji
癌	vro
漳	zvoo
瑁	mebe
硅	gte
斡	wyye
锚	mlhu
玳	deee
耙	pgee
沽	gvoo
颉	joei
湍	tvwo
袤	mpso
卞	buo
纰	psa
壬	reu
褶	zpjo
袄	vpro
肇	zpwo
犁	lthu
鼾	hrhu
邋	lmqa
忻	xyo
淅	xvgo
侨	qiru
诽	fuoa
孪	lmoe
倨	jipu
脐	qnwu
皿	mqia
阗	tnyo
嘣	bowi
螭	ccwi
腴	yneu
骡	lmba
恣	zkio
瘠	jrko
噶	gohi
掸	djke
谙	vuu
愠	yybo
谲	juso
叵	pce
痰	trwo
薯	shqe
袈	jwau
淄	zvmo
彗	heee
恪	kyo
孱	cpda
迄	qizu
蔫	nhse
蜗	wcoi
癞	lrgo
遑	hbe
噫	youi
羯	jebo
鲛	j;uu
涓	jvoo
罂	ymmi
褛	lpko
揩	kjle
嫔	pxaa
褴	lpko
郦	ltne
潢	hvho
镑	bl;u
馥	ft
炖	dwlo
镣	lldu
瘁	cruo
桧	ggi
讧	huo
迩	v;vu
涮	svpo
澹	tv;o
嶙	lwki
徵	zdwu
蔻	kna
豚	tnua
镂	llku
轲	kle
篓	lkku
禺	ybni
樵	qgei
遽	jpe
怵	cygo
孬	hgxe
臃	ynuu
芹	qhei
挞	tjde
偕	jilu
酆	feke
臼	jeu
贽	zziei
碉	dtne
蒯	khne
夙	snua
煊	xwa
蓁	zhde
掖	yju
帚	zena
泠	lvio
臆	ynuu
粤	ybku
銮	lmoe
抒	sjse
偻	liku
庖	proe
椰	yghe
琮	ceae
匮	kce
峋	xwsi
榄	lgke
盹	dqli
轧	zlea
诋	duco
夥	hbgi
憩	qsru
戛	jtqe
瞿	jqqi
佻	tiku
遨	vaee
阜	fcu
镳	blru
蜓	tce
鏖	vrlo
摞	ljbe
忪	zya
噙	qoii
夔	kkro
仞	ri;u
荑	yhde
鸢	ylea
洱	vvo
姣	jxu
腺	xnbu
泱	yvoo
捱	vjre
跆	tzvi
闾	lnoo
犒	kfue
琊	yete
盂	yfee
骥	jmla
岷	mwci
鸶	sssa
痣	zrfo
闳	hnro
帼	gmqi
碴	ctge
芍	shse
犊	dfyu
蝈	gcqi
粽	zkao
侗	tinu
喟	kobi
傥	timu
卟	boia
蓟	jh;e
馊	s;ua
堇	jhoe
踮	dzri
冗	rno
倜	tinu
蹩	bkwo
珩	hede
奂	h;nu
戌	xle
鄢	ytte
濡	rvmo
谀	yueo
镐	hlu
僖	xio
幄	wmpi
狒	fdgu
颛	zwqi
鹧	zrho
箕	jkue
翦	jkho
摹	mdei
愫	syeo
椁	ggu
倌	gia
佝	kisu
萼	vho
骧	xmpa
锹	qltu
娼	cxba
燮	xwwo
弭	mga
诌	zu;o
泗	svqo
鸪	gyei
洵	xvso
雉	zdue
漕	cvqo
怩	nypo
猷	ykdo
贰	vl
汶	wvoo
淆	xvxo
赣	gywo
钊	zlue
轶	ylea
鳍	q;fu
忸	nyoo
喙	hoe
筵	ykru
丶	duoo
橇	qgze
箬	rk
祚	zpoa
燧	swko
沂	yvoo
繇	zmfu
蕙	hhfe
濠	hvno
沅	yvoo
莆	phe
砺	ltre
槟	bga
骛	wswa
刽	giuu
獗	jdru
睑	jqa
岈	ywti
牒	dklu
艮	gra
荥	xnei
妪	yxca
诠	quoa
悖	byyo
唳	lopi
纾	sssa
浃	jvdo
狻	sdvu
蚱	zcia
钏	clue
搡	sjxe
浣	hva
谗	cu;o
麋	mrlo
钺	yllu
宕	dao
鹄	houe
砥	dtce
杈	cgxe
呷	xoia
撸	lj;e
邈	mdbu
膘	bnqu
橄	ggve
滟	yv;o
俪	litu
谤	bu;o
鸩	zmlo
怆	cyoo
忾	kyoo
邝	kro
缮	sse
汾	fvoo
绉	zs;a
攫	jjqe
畸	jbdi
磬	qpne
蹇	jaho
钠	nlu
贻	ymvi
舀	ymu
恁	nieu
箐	qkue
腓	fnua
铝	llo
赳	jze
沏	qvlo
氢	q;xu
檄	xgbe
坂	bfei
炷	zwou
垩	vwe
隽	jqui
驽	nxxa
陲	cpfa
泾	jvxo
蹶	jzri
哺	boia
磺	hthe
匝	zce
讼	sua
掇	djxe
霰	xmne
哔	boli
坯	pfge
蘸	zhqe
嫒	vxa
苓	lhie
遛	lc;u
皋	gbdu
僮	ziuu
跖	zzia
佞	nigu
衩	cpxo
鳗	m;bu
涿	zveo
翳	ycne
糠	kkro
彝	yeka
荔	lh;e
髦	meei
佶	jiui
娣	dxka
胛	jnua
铄	slcu
诘	juoa
濮	pvwo
浒	hvu
敕	cgo
逅	hfo
姹	cxa
迤	yicu
巽	xcca
钜	jlcu
嗑	kofi
舶	bduu
仨	siui
翕	xaou
豸	zduo
厩	jrre
莓	mhi
颀	qruu
锺	zlfu
阚	knvo
舄	xesu
孚	fmu
呶	noxi
呔	todi
蜍	ccia
貉	mduo
莜	yhi
藜	lhte
肪	fnua
膻	snuu
刎	wsdu
氅	cmwi
聃	dhne
泸	lvyo
阪	bpa
懑	mvho
猡	ldqu
圜	yqqi
儆	jihu
逖	tdwu
聒	ghei
邙	mcoe
秣	mtue
汕	svoo
扪	mjei
谒	yubo
衾	qivu
龅	bzu
戗	qiuo
姝	sxau
昶	cuko
埔	pfei
罄	qpne
蛀	zcia
嗳	voia
绶	ssaa
汨	mvoo
谩	mubo
螟	mcni
佥	qau
邂	x;;u
竣	juvo
耘	ygee
俾	biui
沱	tva
蜚	feie
湫	jvto
焊	hwbo
砝	ftfe
舐	sscu
赝	yrie
恹	yyro
蛭	zcti
滇	dvyo
剜	wano
昀	ybsi
缙	jswa
鸵	tsa
樽	zgke
俟	sivu
谆	zuu
裨	ppoa
蒺	jhre
涪	fvu
葩	phbe
诃	huoa
鞅	yfei
踊	yzsi
氐	dclu
荏	rhi
淙	cva
蹴	czzi
藓	xh;e
煅	dwe
谡	subo
猕	md;u
浚	jvvo
淞	svao
瘌	lrgo
潸	svgo
跛	bzia
桢	zgye
坨	tfa
俦	cie
楔	xg;e
铤	tleu
犟	jgca
矍	jqqi
菠	bpe
诮	qumo
笆	bkue
崧	swgi
绥	ssma
獐	zdua
溥	pvmo
恫	dyno
饪	r;u
殄	teie
昴	mbgi
槿	jghe
牦	mfue
馍	m;u
砧	zte
葳	whle
滂	pv;o
绡	xsma
鎏	lvco
骓	zmaa
醐	hqye
囱	cbu
噱	jopi
黜	c;i
哓	xoli
祛	qpfo
抨	pjfe
绺	lsya
咩	moia
醍	tqbe
戊	wle
茁	zhei
佃	diu
蚤	zxu
塾	suzo
谟	muoa
釉	yrku
谚	yuuo
诰	guoa
锟	klbu
灞	bvmo
町	tbia
嗄	soti
逡	qvaa
葭	jhye
柩	jgce
滓	zva
跻	jzwi
棂	lgee
诳	kudo
籽	zkou
囫	hqsi
锷	vlo
碱	jtle
奘	zkfa
獬	xd;u
夯	bde
痿	wrto
痍	yrdo
秧	ytu
榷	qgne
忱	cymo
鱿	y;zu
圉	yqfi
峪	ywia
绌	csa
馗	kzku
酉	yqei
莒	jhoe
嶂	zwi
酡	tqa
崴	wwli
镌	jlqu
殁	meeu
膑	bna
徇	xdsu
纭	ysaa
脶	lnou
鹘	gaia
腌	yndu
叁	svda
碇	dta
晷	gbwi
兕	sui
渚	zvoo
刍	c;u
痘	drto
嚯	homi
莅	lhie
蛎	lcri
龛	kaou
谔	vuo
槊	skno
豢	hjo
胫	jnxu
仝	tiuo
佰	bitu
碜	ctve
殡	beae
绦	tswa
闩	snoi
瘀	yr;o
哞	movi
蓿	xni
驷	smqa
玖	je;e
锲	ql;u
耒	lgee
鄱	prbu
亟	qvja
砣	tta
濯	zvjo
俎	ziiu
糅	rkso
貅	xdi
饯	j;tu
溧	lvqo
犴	vdu
诓	kuco
訇	hsu
嗟	joei
莘	xhei
偈	jibu
乜	mja
靛	dqae
郏	jdke
栾	lmoe
葺	qho
锃	zlou
螯	vaee
泫	xvoo
褓	bpoo
懋	mgge
锉	cli
镫	dlau
掾	yjee
媾	gxha
桠	ygei
枰	pgfe
萋	qhye
稔	rti
荻	dhde
琚	jepe
侩	kii
蝮	fcii
槁	ggei
遴	lkno
岫	xwi
皖	wbau
鹜	wswa
皈	gbu
菟	thei
蓑	shpe
邳	pgte
蔺	lhne
襁	qpgo
徉	yduu
盥	geku
幂	mnbo
觞	s;mu
炅	gbi
貔	pdbu
阡	qpai
呖	lori
蚨	fcia
溉	gvro
懔	lyu
颧	qhqe
糨	jkgo
虱	szra
蜮	ycli
舢	sduu
铩	slxu
鸷	zziei
砀	dtje
咭	joia
腩	nnmu
沆	hvuo
氮	d;wu
忝	ttde
抟	tjge
薜	bhpe
睢	sqia
狴	bdlu
烩	hwi
缃	xsga
悌	tyko
蝾	rcni
抻	cjbe
猢	hdyu
嘞	lofi
爻	yxu
牍	dkyu
嶷	ywdi
蒿	hhe
骅	hmla
钹	blue
嵇	jtuu
孑	jda
俅	qiku
墒	sfei
愎	byio
囡	nqi
饽	b;yu
橐	tyoe
梏	ggei
轸	zli
纂	zkqu
韪	wbzi
黢	q;vi
羸	lco
狍	pdua
撺	cjae
仃	diui
殚	deke
鬣	leme
樟	zgei
桎	zgte
呙	goia
璺	wenu
璎	yeme
镏	ll;u
橹	lg;e
祆	xpto
酵	jqfe
徜	cduu
崂	lwni
铀	ylue
榔	lgu
肓	hco
镁	mle
芩	qhie
狲	sddu
铡	zlmu
祉	zpoa
酪	lqei
酗	xqxe
擢	zjje
珐	fefe
鼬	yeku
啮	nozi
鹑	cudo
椿	cgde
镞	zlzu
镛	ylru
蜢	mcdi
檬	mgne
箔	bkvu
饨	t;lu
貊	mdtu
馄	h;bu
椋	lgue
寮	lado
逦	ltne
蝌	kcti
骢	cmba
蛔	hcqi
辂	llea
诿	wuto
伥	ciui
殓	leae
挝	wjje
诨	huno
爿	qkai
铨	qlue
珲	hene
楸	qgte
赊	smii
窳	yamo
赁	lieu
谌	cuho
聩	khei
煲	biou
钨	wlu
茯	fhi
摺	zjje
罹	lqyi
硭	mthe
掼	gjbe
蚋	rci
旮	gzu
铣	xlfu
絷	zzis
辍	clxe
酊	dqe
蛐	qcbi
暨	jraa
蜇	zjre
镝	dlue
肛	gnua
莠	yhte
砒	pte
邴	bti
栉	jghe
驺	zm;a
柠	nge
歃	sfeu
鳕	x;mu
怼	dxja
訾	zzli
鲧	g;ru
雒	lwu
酩	mqne
黩	d;yi
耆	qfle
嘬	zobi
孢	bda
誊	tjo
斫	zteu
媸	cxwa
岬	jwia
嵬	wwbi
泖	mvgo
蹉	czei
蟊	msca
遒	qkou
缛	rsra
轱	glea
旯	lbia
褫	cpro
谯	quoa
纛	deve
僭	jiau
妁	sxsa
孛	byne
诟	gufo
闱	wngo
谶	cuio
虺	hta
檑	lgme
榈	lgne
跎	tza
牯	gfue
煨	wwbo
悒	yyoo
祧	tpko
瑗	yeme
闫	ynoi
蚺	rcni
獾	hdhu
揆	kjae
诙	huro
嫱	qxya
囿	yqri
箸	zkue
啖	dowi
痂	jroe
廿	nhe
赭	zfme
蔗	zhre
鼹	yeku
篙	gkue
辔	pssa
椤	lgqe
阒	qnqo
埠	bfce
伉	kiu
嫫	mxau
钴	glu
饴	y;vu
荚	jhde
裾	jppo
弁	bvao
衢	qdqu
阕	qna
痔	zrfo
葆	bhie
蟋	xcri
锴	kllu
糸	msa
喑	youi
岿	kwhi
豕	seeu
蚪	dci
笞	ckvu
晗	hbii
蟀	scui
菀	wnne
隍	hpba
逶	wtxu
暝	mbni
茕	qnze
撷	xjo
拮	jjei
獭	tdgu
磔	ztye
滦	lvmo
嘁	qoli
荇	xhde
搽	cjhe
笮	zkue
胪	lnyu
滁	cvpo
泅	qvqo
湎	mvto
娩	wx;a
觥	g;mu
饬	c;iu
徕	ldgu
闰	rnoi
掴	gjqe
璜	hehe
唁	yoia
涝	lvno
汞	g;ei
傈	liqu
錾	zlre
巯	qx;a
鲽	d;lu
讫	qui
俚	liui
姘	pxka
猁	ldtu
菅	jne
耦	vgbe
荟	hhie
谥	suko
绻	qsja
肱	gnru
埙	xfo
铆	mlgu
琨	kebe
狎	xdua
哙	koii
耄	mfle
珉	mece
挈	qe;e
逑	qkue
炻	swo
怄	vyco
鳝	s;e
汛	xvzo
铂	blue
跹	xzfi
徭	ydmu
埂	gfxe
颢	hbvi
猞	sdau
铖	cllu
蓐	rhre
楹	yg;e
貘	mduo
凼	dkia
赅	gmi
稹	ztyu
镗	tlmu
癣	xr;o
铢	zlue
裱	bpeo
倥	kia
涞	lvgo
阆	lnuo
傩	nixu
钎	qlue
蜉	fcmi
悱	fyo
仄	zreu
粕	pkou
纥	hsia
焘	deje
珙	gehe
栎	lgce
胰	yndu
脔	lmio
缳	hsqa
觜	zzli
锝	dlbu
蕤	rhee
唿	hosi
柚	ygei
荜	bhle
鲫	j;ru
洌	lve
螈	ycri
秆	gtue
骞	qaho
蕲	qhye
仵	wiui
苻	fhie
斛	h;mu
搴	qaho
瘙	srxo
獍	jdua
郗	cxru
醴	lqbe
铬	glue
篁	hkbu
杷	pgei
烊	ywou
郜	gou
纩	ksa
脍	kni
鹂	ltne
牝	pfue
骈	pmka
莳	shbe
熨	ypja
钿	tlu
冼	xkfo
柑	gghe
孀	sxma
恚	hgei
氦	h;u
湟	hvbo
锒	llu
锌	xlu
鹬	ysna
戕	qkai
缦	msba
虻	mcia
篾	mkqu
衽	rpo
帏	wmgi
轾	zlte
碣	jtbe
膂	lzro
堞	dfle
暾	tbu
鼐	n;ka
炝	qwo
窨	yauo
鲟	x;eu
偬	zisu
硌	gteu
恽	yyno
咴	hori
竦	sugo
邰	tvoa
虢	gmju
覃	tqbe
韭	jei
蕨	jhre
铉	xlue
泵	bteu
帧	zmyi
胱	gnmu
缟	gsa
屐	jpda
苌	chei
腱	jneu
侔	mivu
鳃	s;bu
讦	juoa
圻	qfe
椽	cgee
癯	qrqo
灏	hvbo
洮	tvko
拊	fji
眙	yqvi
尜	gvdi
骝	lm;a
髭	zeze
蝰	kcdi
痨	lrno
竽	yku
狯	kdi
剡	ywwo
鼋	yaoe
腚	dna
猱	ndsu
辚	llke
螫	sfwe
缢	yska
酶	mqie
嘌	poqi
椴	dgee
洹	hvto
趺	fzi
盱	xqia
犍	jfeu
镊	nlhu
噻	soai
庹	trho
钙	gltu
赡	sm;i
罅	xfpu
珥	vee
狃	ndua
镙	llbu
撄	yjme
圩	wfei
杌	wgte
峄	ywxi
箴	zklu
炔	qwou
茔	ynei
墉	yfre
鏊	vaee
焙	bwuo
馏	l;;u
畲	sipu
欹	ydje
洇	yvqo
吡	boia
仟	qiui
馐	x;eu
宥	yaro
鼍	too
苫	shei
囹	lqii
荛	rhle
氯	l;e
昃	zbri
缱	qsca
峤	jwri
龈	kzu
睇	dqki
娈	lmoe
蹼	pzwi
榛	zgde
蟥	hchi
臬	nr
殳	snua
擀	gji
旄	mzo
犰	qdu
彀	gfge
狁	ydvu
诤	zu;o
傣	didu
裢	lplo
搠	sjke
樨	xgpe
鹌	vdle
踟	czdi
铰	jluu
焖	mwno
痢	lrto
锰	mldu
厣	yrde
瘐	yreo
蠹	dyce
楫	jgo
澧	lvbo
郓	ynlo
秸	jtue
砦	zzli
璁	cebe
柞	zgei
纫	rs;a
纡	ysaa
腭	vno
骐	qma
黟	y;ni
瘿	yrmo
捭	bjei
芨	jhei
笳	jkue
嵯	cwe
颏	kdo
郧	yomi
妣	bxa
钾	jlue
酃	lmoe
圄	yqei
稞	ktbu
苡	yhei
杼	zgse
戡	khle
勐	mdqa
薨	hhee
蛉	lci
澍	svoo
雩	ymge
骘	zpza
憷	cygo
茴	hhqe
诜	sufo
淖	nvyo
筅	xkfu
佚	yiui
襦	rpmo
郇	xsbu
吖	voki
檫	cgae
帔	pmia
垭	yfei
凫	fsua
鹗	vosi
钯	plu
邗	hfee
舛	cnu
謇	jaho
荠	qhwe
佤	wiui
矽	xte
喁	yobi
粑	bkou
垓	gfei
苕	thei
浔	xve
芫	yhei
煸	bwpo
蝓	ycai
迓	ytje
杓	sgse
躅	zzqi
褡	dpho
矾	ftne
喈	joli
沔	mvto
樘	tgme
锨	xlru
蜊	lcti
搦	njge
鲵	n;e
烷	wwa
蕈	xhqe
刭	jx;a
丨	syi
幛	zmia
踯	zzki
堠	hfpe
闼	tndo
愀	qyto
鄯	seo
缁	zsma
氰	q;u
瓤	rpoo
肜	rnu
摈	bjae
氟	f;gu
厶	svao
瀣	xvxo
鲰	z;hu
怫	fygo
坩	gfhe
陉	xpxa
疟	yroe
褰	qaho
渑	mvoo
笫	zksu
裣	lpao
菸	yh;e
痼	grqo
阄	jn;o
缗	msca
媪	vxba
疱	proe
悭	qyxo
尻	kpa
罴	pqfi
燹	xeee
疥	jri
衿	jpio
艏	sdku
亳	bnro
邛	q;ei
眭	sqia
旒	lzco
茏	lhei
樯	qgye
艄	sdmu
孳	zkso
鲶	n;i
卅	sme
黍	sti
鲑	g;u
氖	n;u
怛	dybo
枋	fgei
蒹	jhke
菘	shge
豌	wtke
泶	xmoo
笏	hksu
忉	dyo
淝	fvno
榉	jgme
踽	jzri
廪	lruo
裎	cpoo
桁	hgde
萑	hhei
濂	lvro
鲈	l;yu
疹	zrio
逋	bmei
栳	lgfe
蚍	pci
苒	rhne
蝣	yczi
铙	nllu
殍	peme
陂	ppai
埚	gfo
麂	jrlo
妊	rxa
唢	somi
锗	zlue
擘	bpua
趸	dtje
赍	jyie
谰	luno
歙	saju
縻	mrgo
焯	cwyo
矬	cdi
烯	xwxo
荩	jhce
艨	mdnu
眇	mqia
瓴	lisu
亍	cgee
佧	kiyu
叻	loia
箝	qkju
勰	x;;a
氨	v;ue
喱	lori
飨	xsra
翥	zfei
侪	ciwu
桫	sgve
鲠	g;xu
茑	nhei
蚝	hci
跗	fzii
焓	hwio
洄	hvqo
疽	jroe
笤	tku
篦	bkbu
鹕	hyne
雎	jhia
胺	vnu
蹰	czri
阋	xneo
钬	hlue
镪	qlgu
馕	n;yu
艟	cduu
毂	gfle
鹈	tkro
庠	xro
猗	yddu
瞽	goye
疴	kroe
踅	xjre
棼	fgei
睾	grqu
鹳	ghqe
疡	yrjo
锍	llcu
漭	mvho
跸	bzli
醮	jqe
砬	lteu
濉	svqo
柢	dgce
泷	svoo
逄	pwyu
埘	sfbe
陟	zpza
耋	dfle
笄	jktu
蚧	jcii
蝥	mswa
塄	lfqe
萘	nhde
郯	twwo
烃	twxo
酮	tqne
彖	tea
痫	xrno
鼙	poye
掮	qjpe
趿	tzi
帑	txxa
馔	z;cu
鲇	n;ua
畦	qbia
蚜	ycti
枸	jgse
狷	jdo
尢	yzeu
稗	btue
窠	kabo
溘	kvfo
矸	gteu
岢	kwia
沭	svgo
钲	zltu
蠃	lcoo
睃	sqvi
庾	yreo
扦	qjei
鸱	cclu
哚	doni
菔	fhne
枥	lgre
轳	llye
蟛	pco
觋	x;ie
祜	hpoa
蚰	ycia
狳	ydua
倬	ziyu
锱	zlmu
蛄	gcia
醪	lqje
囟	xbu
爰	ymfu
奁	ldce
擤	xjre
槎	cgee
鞒	qfre
嬗	sxu
嗉	soe
鳐	y;mu
柘	zgei
毖	blce
舸	gduu
镍	nlru
鋈	wvro
潆	yvno
侑	yiru
谘	zuio
耔	zgee
锕	vlpu
豳	bwe
芾	fhte
乩	jzni
渌	lveo
禳	rppo
綦	qhse
锑	tlku
钤	qli
砭	btre
鳏	g;qu
辊	glbe
娠	sxra
鬻	ygga
洙	zvoo
墀	cfpe
孥	nxxa
疣	yrzo
茇	bhei
耪	pg;e
芪	qhce
愆	qdgu
筮	sk;u
榫	sgqe
栀	zgfe
薅	hhxe
萁	qhei
蜞	qcia
蛩	q;ne
罨	yqdi
鳟	z;ku
阍	hnco
龃	jzui
莰	khfe
酽	yqwe
栲	kgfe
氪	k;yu
饣	s;ua
崤	ywxi
啁	zoni
铋	blcu
碘	dtne
觚	g;mu
毽	jzeu
捌	bjwe
樾	ygze
瘢	brdo
茌	chie
鹚	ckso
骶	daci
菏	hpe
糁	skvo
穑	styu
溏	tvro
刖	ynua
嫜	zxa
螽	zwcu
缒	zsca
滹	hvpo
髋	kaai
攮	njye
楂	zgge
戽	hpoa
铧	hllu
囝	jqia
愍	mcwa
坭	nfpe
熵	swou
澶	cvuo
鲂	f;ua
鞯	jfhe
橛	jgre
飧	snua
痈	yroe
枞	cgi
殂	cee
冱	hkto
匏	pdse
蠼	qcqi
嵊	swti
艉	wdpu
岙	vrdu
樗	cgme
遄	cwti
舂	cdee
椟	dgye
尕	g;au
柙	xgei
伧	ciui
坻	cfce
瓠	hdse
镬	hlhu
髡	kete
薮	shxe
蔌	shge
龉	yzu
鹾	cyqi
讣	fuoa
皲	jnlo
髁	kabi
杲	gbia
芰	jhye
椐	jgpe
橼	ygee
缯	zska
鸹	gsue
龋	qzu
莪	vhje
锞	klbu
圹	kfei
黧	ltsu
隈	wpba
彘	zeda
暌	kbai
餍	yrde
赜	zcee
筚	bklu
泔	gvho
嘏	jype
疠	lrto
鸬	lypi
檠	qhwe
饧	t;ju
醯	xqce
蚬	xcia
蓖	bhbe
哏	hoia
蹁	pzpi
朐	qnsu
疋	pva
甑	zkbo
绂	fsaa
铗	jldu
髫	tee
螅	xcri
宄	gaoo
芎	xhei
摭	zjre
膣	zna
苷	ghhe
骟	smpa
圯	yfei
棹	zgye
枳	zgo
啭	zogi
蔟	chze
妫	gxka
鍪	mswa
夤	yna
牖	ykpu
觯	z;mu
棰	cgfe
盍	hfve
茭	jhu
耨	ngre
鞣	rfse
钡	blue
礅	dtu
苴	jhei
熘	lw;o
硼	ptne
秫	stgu
铊	tla
柁	tga
壅	yuso
飑	bnua
膈	gntu
钪	klu
箜	kka
缡	lswa
醚	mqke
敉	mkou
甯	naco
潍	wvso
寤	wako
肄	yldu
阈	ynlo
跏	jzi
栊	lgei
栌	lgye
涑	svgo
脘	gnau
酎	zqe
柒	qvlo
谵	zu;o
鲳	c;bu
茈	zhze
痱	froe
鬈	qeje
蛳	scti
秭	ztru
阏	vn;o
捩	ljpe
镆	mlu
枇	pgei
枵	xgo
氚	c;ue
皴	cvwa
堀	kfpe
讴	vuco
圊	qqia
穰	rtpu
蟮	sce
忄	xyoo
笥	skju
焐	wweo
菖	chbe
绐	dsva
儋	di;u
邡	f;oe
蓼	lhje
蒌	lhke
圮	pfei
浠	xvxo
廨	xr;o
怙	hyoo
闶	knu
瓿	buoo
诂	guoa
粳	jkxo
鳓	l;fu
漯	tvbo
眚	sreu
庑	wrfo
苎	znei
觳	hfme
楗	jgee
徼	jdbu
莨	lhu
黥	q;ui
芴	whse
酰	xqfe
柽	cgxe
钭	tlue
揿	qjle
蓊	wha
馑	j;hu
喾	km
僳	siqu
揎	xja
挹	yjoe
芏	dhe
剀	kwci
愦	kyoo
曩	nbpi
袢	ppoa
酾	sqte
硒	xteu
曛	xbfi
俣	yio
笊	zkue
卮	zfu
汊	cvxo
郴	cgei
雠	cquu
鲷	d;nu
仂	liui
莴	who
癍	breo
榧	fgce
鹣	jkmo
蘖	nhce
旆	pzto
蕖	qpce
桡	rgle
荪	shde
婺	wswa
妯	zxau
钣	blue
亻	riui
垆	lfye
沤	vvco
屣	xpda
卺	jvka
嫠	lgre
蘼	mhre
坶	mfei
蘧	qhpe
镒	ylku
蕞	zhhe
玢	feee
厝	crhe
锆	glue
鬲	gto
詈	lqia
箧	qkcu
铴	tlvu
怃	wyfo
浜	bvro
鳔	b;qu
缶	ffu
藿	hhme
蛑	mcvi
柰	ngei
鼗	tkku
蓥	ynei
欤	ysea
钚	blue
丌	jheu
蛞	kci
娌	lxa
鲆	p;fu
癔	yruo
鄣	zyoe
酢	zqei
骖	cmva
酲	cqo
碓	dte
妗	jxi
麈	zrlo
傧	bia
燔	fwro
黻	fwmi
缂	ksaa
鹩	ldve
碛	qte
铱	ylue
塬	yfre
韫	ygpe
揸	zjge
趵	bzsi
屙	vppa
猓	gdbu
檩	lgue
谝	pupo
笸	pkcu
蜣	qce
溽	rvro
蜩	tcni
乇	tru
囗	wqi
痦	wre
赀	zzli
萏	dh;e
偾	fiyu
鄄	jqfe
岘	xwia
揠	yjce
伛	yicu
碚	btue
阊	cnbo
蕺	jhhe
孓	jvja
镧	llnu
锊	llmu
铍	plue
溱	zvdo
昝	zwyu
胙	znua
瑷	veee
邶	bkli
坫	dfei
伲	nipu
芑	qhei
缬	xsoa
硎	xtte
镟	xlzu
糌	zkyo
隹	zqui
坼	cfre
幞	fmwi
戢	johi
崃	lwgi
髀	bai
忭	byu
箪	dkku
瞢	mhqe
筌	qkue
菽	shve
荨	qhee
郅	ztfe
锛	bldu
笾	bk;u
篪	ckru
辏	clde
癜	drpo
钒	flnu
哕	yowi
敫	jb;u
廑	jrho
鲢	l;lu
仳	piui
厍	sreu
砷	stbe
蓍	shfe
鳎	t;bu
圬	wfge
欷	xxru
碹	xta
甏	bove
檗	bpua
豉	ctke
淦	gvoo
磙	gtpe
苣	jhce
艿	nhei
颞	nhxe
嗍	soki
胝	zncu
槠	zgue
诼	zue
诹	zuho
麸	fewe
蛱	jcdi
鞫	jfse
锂	llue
荞	qhre
轫	rl;e
椹	sghe
郾	ycbe
楱	cgde
迨	dvoa
氘	d;u
槲	hg;e
耩	jghe
熳	mwbo
缌	ssba
恂	xyso
铟	ylqu
卣	yyqi
唣	zobi
苁	chie
裉	kpo
瘰	lrbo
泺	lvco
锘	nlhu
璩	qepe
薹	tho
阌	wnoi
堙	yfqe
茺	chce
砩	ftge
蓠	lhwe
啉	loia
黾	mobi
诒	yuvo
唑	zoii
砗	cteu
羝	deco
顸	hfee
刳	kdse
杩	mgei
俳	piui
慊	qyko
缫	ssma
茼	thne
狺	ydua
缍	dsfa
圪	gfi
麇	jrlo
悝	kyoo
尥	lzse
狨	rdlu
铯	sl;u
嗾	sozi
胗	zni
痤	cri
隳	hpra
镢	jlru
鹋	mhbe
槭	qgle
畹	wbai
嵛	ywa
饫	y;ru
蘩	fhie
赓	greo
绲	gsba
翮	htne
郐	kiuu
缧	lsba
酹	lqme
唛	moe
颟	mhqe
蠓	mcni
眄	mqti
葚	rhhe
腧	sna
溲	svoo
溻	tvbo
踬	zzri
怍	zyoo
畚	bvda
嬖	bpua
糍	ckko
旰	gbia
鞲	gfhe
涫	gva
颃	huno
荭	hhse
嵴	jwki
垲	kfwe
呒	fofi
胼	pnku
芡	qhei
朊	rnua
馓	s;hu
跣	xzfi
刈	yxuo
萸	yhee
龠	yaou
帻	zme
瘳	crjo
疸	drbo
磴	dtae
陔	gpai
醢	hqre
踺	jzei
蠲	jkqo
蛸	xcmi
硖	xtde
鲞	xjou
蚴	ycsi
镲	cla
戥	dbe
葑	fhge
篌	hki
栝	ggei
耧	lgke
峁	mwgi
堋	pfne
芘	phei
謦	qpne
鸲	qsou
颡	sxga
鄞	yhee
嗌	voki
踔	czyi
疔	droe
铒	vlu
犭	qdua
桄	ggme
屦	jpda
侉	kidu
粝	lkro
瘘	lrko
痧	srvo
绨	tska
葸	xhbe
薏	yhu
仉	ziui
廛	creo
簟	dkqu
裰	dpxo
畈	fb
鲋	f;i
舻	ldyu
皤	pbru
嗪	qodi
凇	ska
谇	suu
掭	tjte
燠	ywbo
虿	ctje
莼	chse
毳	czzu
簦	dkau
蹀	dzli
胍	gnua
缣	jska
枧	jgei
鲮	l;fu
陧	npba
泮	pvoo
梃	tge
醑	xqve
勖	xbqi
谖	xumo
谳	yudo
铘	yltu
轭	vlre
酐	gqei
庋	gryo
僬	jiui
贶	kmo
醅	pqu
蝤	qcia
垧	sfbe
锬	tlwu
趑	zzke
菹	zpe
龀	czui
藁	ghu
诖	guoa
匦	gcle
笕	jkue
硷	jtae
锩	jlju
垅	lfei
肭	nnua
陴	ppai
吣	qoia
醛	qqhe
蒴	shwe
邾	zgue
鳊	b;pu
鸸	vtqe
桴	fgme
搿	gja
胲	hnu
剞	jdje
鬏	jete
芤	khde
嵝	lwki
艋	mddu
悛	qyvo
疝	sroe
柝	tgre
鲔	w;ru
拶	zjme
黹	zwki
舯	zdou
箅	bkbu
榇	cgei
菰	ghde
煳	hwyo
劂	jrke
蚵	vci
礞	mtne
钼	mlue
嬲	nb;i
劬	qsou
肽	tndu
洧	wvro
硪	wtje
葙	xhge
埸	yfbe
廴	yza
躜	zzfi
鬯	cxu
匚	fce
鲱	f;ua
砜	fte
呋	foia
莩	phme
鹨	ljva
墁	mfbe
觫	s;mu
辋	wlne
隰	xpba
獯	xdfu
佾	yia
媵	ynju
趱	zzfe
髌	baa
埕	cfo
谠	dumo
碲	dt;e
垤	dfte
唪	fodi
绀	gsha
铪	hla
洚	jvwo
嫘	lxba
楝	lgge
甍	mhqe
髂	qaa
磲	qtce
绱	ssaa
潲	svmo
鲥	s;bu
铵	vlue
舨	bduu
羼	cpea
笪	dkbu
酚	fqe
刿	gwni
曷	hbsi
溷	hvqo
骱	xaii
胬	nxxa
俜	pibu
銎	q;ne
诎	quoa
枘	rge
镡	tlqu
粜	tca
浯	wve
绁	xsaa
崦	ywdi
劓	yrhu
蓣	yhje
菝	bhje
鐾	bpua
蛏	ccxi
汆	cruu
甙	dlhe
蒽	vhqe
绋	fsga
岣	gwsi
崮	gwqi
岵	hwia
掎	jjde
挢	jjre
讵	juco
窭	jako
赉	lgke
掊	pju
芟	shei
毹	sahu
锶	slbu
慝	tche
氽	tiuo
芄	whze
怿	yyxo
鹆	ywuo
瘵	zra
啶	doai
蔸	dhbe
砘	dtle
罟	gqia
蚶	hchi
鲎	hmo
锾	hlmu
湔	jvko
搛	jjke
柃	lgi
逯	leka
亓	qgee
屺	qwi
郄	xxru
檎	qgi
毵	svva
渖	svao
肟	wngu
饩	x;ua
躞	xzwi
谮	zua
酯	zqle
塍	cnju
擐	hjqe
蠖	hchi
觖	j;mu
跬	kzi
氇	lz;u
嘧	moa
蝻	ncmi
湓	pvao
氆	pzku
庥	xri
嵫	zwki
撙	zjke
褊	bppo
篼	dkbu
鳜	g;ru
劢	mtje
蛴	qcwi
汔	qvio
骀	dmva
醣	tqre
腽	wnbu
舾	xduu
仡	gii
莸	yhde
黼	fwmi
袼	gpoa
缑	gspa
笱	gksu
袷	jpao
肼	jnua
僦	jizu
蒉	khei
阃	knqo
臁	lnru
倮	libu
芈	myti
杪	mgei
蠛	mchi
蛲	ncli
凵	qua
硗	qtle
跫	q;ne
荽	shme
渫	xvlo
崾	ywqi
瘗	yrdo
箦	zkeu
舳	zduu
阝	fpai
黪	c;vi
锸	clfu
瓞	dmu
滏	fva
戆	zywo
遘	ghne
簋	gkru
鹪	jjui
扃	jpno
篥	lkqu
鞔	mf;e
浼	mv;o
庀	proe
肷	qnu
鲭	q;ua
埽	sfee
钽	tlbu
酴	tqe
溆	xvyo
钸	blru
髑	daqi
鳆	f;iu
黉	hmho
逭	haco
浍	hvio
裥	jpno
榘	jdcu
犋	jfhu
钌	llvu
躐	lzmi
砻	lxeu
苤	phge
榀	pgo
钋	plue
綮	qpwo
氵	svoo
胂	snbu
锼	slu
炱	tvoa
疃	tbui
煺	twro
鼯	weku
籼	xko
芗	xhse
儇	xiqu
砟	zteu
肫	znlu
秕	btue
踣	bzui
刂	dhi
帱	dme
氡	d;wu
垌	dfne
佴	viu
糇	hkpo
肀	yeae
澌	svho
耜	sgee
龆	tzu
禊	xp;o
溴	xvro
氩	y;ue
吲	yogi
岜	bwi
惝	cyoo
蝽	ccdi
腠	cndu
徂	cduu
硐	dtne
镉	gltu
虼	gcii
烀	hwro
蟪	hcfi
桷	jg;e
坜	lfre
瞵	lqki
簏	lkru
镘	mlbu
擗	pjpe
筇	qk;u
扌	sjei
畋	tbia
葶	thne
沲	tvi
穸	xaoo
眢	yncu
搌	zjpe
埴	zfye
陬	zpha
砹	vthe
畀	bbia
鹁	byde
觇	czni
彳	cduu
瘅	drko
菪	dne
铞	dlo
锇	vlju
钫	flu
廾	gheu
砉	heee
锪	hlsu
哜	jowi
钅	jlue
锔	jlpu
膦	lnku
螨	mchi
茆	mhge
埤	pfei
铈	sluu
裼	tpbo
迕	wfue
氙	x;ue
楦	xgae
讠	yuoa
蛘	ycia
镱	yluu
霪	ymve
畛	zbii
碡	dtee
缵	zsfa
锿	vlpu
襞	bpua
髟	beei
蒇	chle
冁	ckyo
籴	dru
揲	sjle
镦	dluu
苊	vhre
疳	grho
茛	ghei
鳇	h;bu
攉	hjme
虮	jcia
镓	jla
噍	joia
弪	jgxa
胩	knyu
罱	lqmi
苈	lhre
蠊	lcri
埝	nfi
钕	nlue
羟	qexo
羰	tewo
轺	ylea
舴	zduu
潴	zvdo
萆	bhei
晡	bbia
爨	cenu
榱	cgpe
铥	dlfu
鸫	dlve
胨	dnlu
罘	fqi
槔	ggbe
鹱	hshu
墼	jlne
骒	kmba
悃	kyqo
漤	lvgo
稂	ltu
诔	luoa
鲡	l;tu
疬	lrro
钔	mlue
淠	pvbo
裒	ppoe
缲	qsoa
薷	rhme
埏	sfre
谂	suio
鲦	t;wu
莛	thee
榍	xgpe
髹	xei
砑	ytte
垸	yfa
帙	zmia
窀	zalo
浞	zvoo
辶	czo
褙	bplo
苄	bhu
骣	cmpa
舡	gduu
岽	dwli
攵	pwu
赙	fmmi
漶	hvoo
跽	jzci
疖	jroe
腈	jnua
桕	jgei
桊	jjou
埒	lfme
镅	mlpu
镎	nla
哌	pori
郫	pbiu
冖	mnoa
锖	qlue
畎	qbdi
悫	qfne
颥	rmqe
唼	sou
钐	slue
矧	sdgu
牾	wfeu
鹇	xngo
殪	yefe
鳙	y;ru
饔	yuso
籀	zkju
鄹	zhke
宀	maoo
坌	bauo
荸	bhye
艚	cdqu
艹	chei
觌	dyke
铫	ylku
鲼	f;yu
澉	gvvo
哿	gwa
瘊	hri
骺	hafi
豇	jtke
筘	kkju
硇	ntbe
聍	nhei
蜱	pcia
丿	pruu
氍	qqqi
酞	tqde
钍	tlue
沩	wvko
洫	xvro
珧	yeke
舁	yeui
瀹	yvao
粢	zkio
鲅	b;ua
鞴	bfhe
窆	baro
瘛	creo
镄	flgu
祓	fpoa
恝	je;e
瘕	jrpo
戋	jtee
鲒	j;ua
醵	jqpe
瘼	mroe
铌	nlpu
脬	pnmu
葜	qhee
椠	qlre
瞍	sqia
羧	sevo
冂	jni
粞	xkou
蓰	xhde
窬	yaa
哳	zoji
轵	zloe
忮	zyyo
埯	vfde
聱	vaee
礤	cthe
搋	cjre
憝	duwo
钆	glue
艽	jhei
鳘	miwu
恧	ntqe
襻	ppgo
氕	p;u
镨	plku
铷	rlxu
洳	rvxo
蟓	xcia
鸺	xigu
铕	ylru
驵	zmaa
迮	zsue
廒	vroe
濞	bvro
巛	cmaa
嶝	dwai
耵	dhei
蹯	fzri
篚	fkcu
嚆	hohi
劐	hhxe
鲚	j;wu
鲣	j;xu
趼	jzti
赆	jmci
爝	jwmo
钶	klue
鳢	l;bu
荬	mhve
镤	plwu
桤	qgwe
筲	skmu
堍	tfei
箨	tkju
蕹	whre
钇	ylue
罾	zqki
夂	zwu
橥	zdfu
鲻	z;mu
阼	zpai
揞	vju
庳	broe
馇	c;gu
怊	cyoo
脞	cni
埭	dfee
塥	gfte
绠	gsxa
蕻	hhve
鲩	h;a
癀	hrho
洎	jvro
礓	jtte
捃	jjee
锎	klnu
轹	llce
跞	lzci
瞀	mswa
猸	mdpu
鹛	mpqa
脒	mnua
耱	mgre
衄	nrqu
甓	ppua
锓	qleu
脎	snxu
滠	svho
鲐	t;vu
萜	thme
砼	ttie
涠	wvqo
衤	ypoa
甾	zmaa
痄	zroe
浈	zvyo
瘃	zreo
舭	bduu
螬	ccqi
躔	czri
枨	cgei
眵	cqni
镩	clau
卩	jpai
垡	filu
稃	ftmu
郛	fmdu
酤	gqei
崞	gwu
蜾	gcbi
捍	hjbe
谫	juko
纟	msaa
眍	kqci
癃	lrpo
毪	mzvu
仫	miru
垴	nfwe
筢	pkju
锫	pluu
螵	pcqi
岍	qwti
亠	tuoe
阢	wpta
菥	xhge
鼷	xeku
薤	xhee
舣	yduu
著	zhei
丬	pkoe
腙	znau
蒡	bh;e
勹	bsu
鹎	bbiu
滗	bvko
缏	bsi
醭	bqwe
猹	cdgu
瘥	creo
膪	cn;u
阽	dpai
簖	dklu
牿	gfue
馘	gkqo
撖	hjve
虍	hpi
缋	hsaa
牮	jlui
铼	llgu
铹	llnu
泐	lvpo
墚	lf;e
镥	ll;u
苠	mhce
脲	nnpu
蒎	ppre
犏	pfpu
钷	plcu
劁	qju
鼽	qrhu
磉	stxe
鲺	s;zu
礻	spoa
贳	slei
摅	sjpe
耥	tgee
螗	tcri
箢	yknu
軎	wlei
莶	xhae
痃	xroe
痖	yroe
疰	zroe
碥	btpe
瘭	brqo
傺	cia
鼢	feku
瀵	fvko
艴	fgha
戤	g;qa
筻	gkxu
觏	ghne
鲴	g;qu
轷	hlre
耠	hgae
灬	hto
茳	jpei
喹	kodi
醌	kqbe
蒗	lpu
铑	llfu
耢	lgne
蔹	lhme
稆	lto
攴	pyi
苘	qhne
赇	qmki
辁	qlea
彡	svu
赕	dmwi
铽	tllu
猃	xda
糈	xkvo
酏	yqei
茚	yhee
齄	zrhu
绗	hsda
荮	zhse
夼	kdeu
螋	sci
耖	cgee
蒈	khle
鲕	v;tu
禚	zpeo
鳋	s;xu
冫	bkoe
屮	cwai
彐	jea
疒	croe
