一个	tyiv
我们	jlin
自己	cmej
没有	vogk
可以	jkby
发展	nfra
中国	ovze
工作	vgik
什么	iycv
这个	wriv
就是	xvft
他们	iuin
问题	nofr
进行	urdl
社会	dhia
企业	iroy
经济	sbvw
知道	eoqc
这样	wrgm
研究	ttak
现在	eugh
还是	mrft
因为	zdes
教育	eipk
国家	zeaq
今天	idtd
时间	fjnf
管理	naeh
不能	mbvk
市场	pbhl
活动	vaas
建设	bhuo
已经	eysb
如果	xofg
怎么	kccv
技术	jygu
重要	ahdx
生产	cmwc
生活	cmva
世界	usni
时候	fjir
一种	tymo
第一	ncty
喜欢	kqxf
人民	irel
大家	ddaq
这种	wrmo
开始	thxv
通过	sjjr
需要	ztdx
一定	tyat
可能	jkvk
提高	jfxg
你们	imin
也不	uymb
学生	zicm
这是	wrft
哈哈	oaoa
中的	ovus
方法	tfvh
主要	pzdx
系统	cssp
这些	wrrl
一起	tyre
影响	fvou
发现	nfeu
这一	wrty
要求	dxzu
那么	lpcv
一些	tyrl
还有	mrgk
起来	reqk
看到	jmth
作用	ikjy
结果	skfg
同时	ntfj
情况	yleo
真的	ygus
关系	kdcs
组织	sgso
不同	mbnt
这么	wrcv
上海	itve
我国	jlze
必须	ccqt
公司	mvet
但是	ifft
北京	klxv
所以	zrby
发生	nfcm
不知	mbeo
认为	uies
由于	eyhy
觉得	zudf
也是	uyft
治疗	vvfd
文化	wwil
希望	xgpk
政府	trri
成为	lees
出现	vceu
方面	tftc
领导	isej
为了	esdj
服务	kpws
美国	mdze
只有	omgk
产品	wcoo
具有	gmgk
在这	ghwr
使用	ixjy
作为	ikes
只是	omft
有关	gkkd
两个	zliv
环境	emho
科学	mkzi
目前	mmqx
因此	zdrl
全国	sqze
思想	ncgm
设计	uouy
信息	iucm
国际	zepn
学习	ziex
分析	mfgd
过程	jrmo
一下	tyox
应该	rzus
基础	mhtv
一次	tyef
一直	tyyg
出来	vcqk
而且	tigq
控制	jaqn
东西	yvdx
能力	vksl
部门	wonm
支持	yxjh
记者	ueez
精神	kldf
城市	hlpb
孩子	isiz
改革	ewcg
人员	irod
所有	zrgk
其中	mqov
一样	tygm
地方	hutf
朋友	kkgx
各种	wgmo
不过	mbjr
得到	dfth
那个	lpiv
实现	aoeu
基本	mhgt
结构	skgs
最后	fbko
质量	zyft
细胞	snks
增加	hkwj
存在	gigh
这里	wrhl
以及	bylj
感觉	ltzu
女人	xnir
工程	vgmo
形成	thle
一点	tyit
采用	egjy
代表	mdmq
不可	mbjk
个人	ivir
提供	jfia
建立	bhwl
第二	ncwe
特别	qhka
选择	qajx
学校	zigp
根据	gkjr
开发	thnf
方式	tflv
然后	buko
之间	gznf
今年	idev
虽然	osbu
比较	lbyp
一般	tybo
标准	gney
加强	wjco
条件	wgiq
功能	vsvk
投资	joef
历史	zsox
解决	mjet
自然	cmbu
利用	majy
一个人	tii
处理	wieh
很多	dkbb
男人	nsir
知识	eouo
继续	sksy
制度	qnrh
一切	tylm
到了	thdj
其实	mqao
明显	fkfo
可是	jkft
提出	jfvc
获得	hqdf
安全	yasq
理论	ehui
别人	kair
其他	mqiu
说得好	udx
为什么	eic
我也	jluy
应用	rzjy
人们	irin
不知道	meq
对于	xjhy
健康	ibrb
幸福	hqdp
参加	vdwj
过去	jrhv
现代	eumd
回复	zoef
决定	etat
产生	wccm
以上	byit
干部	hgwo
变化	rxil
新的	ndus
一天	tytd
努力	xxsl
教学	eizi
群众	bcii
资源	efvz
不断	mbki
许多	uqbb
项目	vtmm
表示	mqns
规定	yuat
我是	jlft
以后	byko
完全	ajsq
成功	levs
非常	bfzb
如何	xoij
那些	lprl
有些	gkrl
实际	aopn
有效	gkpr
积极	mogl
认识	uiuo
直接	ygjw
单位	kfiw
明天	fktd
政治	trvv
完成	ajle
小时	vxfj
表现	mqeu
经营	sbxo
之后	gzko
部分	womf
患者	ooez
让我	uijl
终于	swhy
中心	ovcx
关注	kdvp
达到	drth
并不	qhmb
我就	jlxv
保护	iojq
坚持	axjh
进入	urcu
任何	isij
日本	frgt
才能	jcvk
事情	joyl
原因	zuzd
内容	knaw
注意	vpwf
行为	dles
给我	sajl
看看	jmjm
包括	sbja
进一步	utr
计算	uynm
原来	zuqk
突然	adbu
正在	trgh
报道	jpqc
结合	skao
地区	hujx
政策	trng
合作	aoik
只要	omdx
运动	aras
目标	mmgn
本报	gtjp
人生	ircm
网络	nxsw
告诉	kgud
如此	xorl
无法	hivh
我要	jldx
快乐	ytpv
效果	prfg
改变	ewrx
不仅	mbix
计划	uyla
准备	eywn
检查	gagf
不错	mbla
是一个	fti
科技	mkjy
价值	iiiy
会议	iauu
增长	hkyc
意义	wfux
国内	zekn
严重	ocah
十分	ysmf
另一	klty
法律	vhdb
专业	wvoy
地址	huhr
我们的	jiu
每天	eotd
最大	fbdd
促进	ibur
正常	trzb
综合	saao
真是	ygft
艺术	hggu
稳定	mmat
实施	aotu
造成	krle
真正	ygtr
甚至	mitv
能够	vkso
传统	iwsp
责任	mdis
生命	cmao
数据	kxjr
价格	iigw
经过	sbjr
了解	djmj
实验	aoza
机构	gngs
社会主义	dipu
工业	vgoy
电话	fiua
回来	zoqk
第三	nccs
保证	iout
临床	anrg
大学	ddzi
调查	ungf
教师	eiat
培养	hwmu
因素	zdms
开展	thra
农业	bqoy
材料	gjkk
晚上	fmit
取得	bxdf
推荐	jyhg
开心	thcx
转发	ywnf
回家	zoaq
参与	vdsy
三个	csiv
程度	morh
有点	gkit
产业	wcoy
以为	byes
相信	gmiu
或者	loez
分别	mfka
永远	uzjr
更多	xfbb
个月	ivky
都有	epgk
而是	tift
引起	cvre
形式	thlv
重点	ahit
根本	gkgt
同志	nthc
充分	pamf
农村	bqgj
接受	jwex
机会	gnia
只能	omvk
分享	mfxi
关于	kdhy
几个	njiv
全面	sqtc
减少	elms
措施	jatu
人才	irjc
资金	efsj
多少	bbms
也有	uygk
以来	byqk
任务	isws
建筑	bhnv
容易	awfs
保持	iojh
是个	ftiv
是否	ftmo
实践	aobt
经验	sbza
随着	pgmm
竞争	womb
爱情	egyl
创造	jakr
每一	eoty
当然	ebbu
最近	fbdr
分钟	mflo
心理	cxeh
简单	nnkf
创新	jand
每个	eoiv
也没	uyvo
统一	spty
全部	sqwo
监督	anix
就会	xvia
电影	fifv
发挥	nfja
总是	koft
整个	gwiv
眼睛	mkml
调整	ungw
好好	xixi
农民	bqel
中央	ovty
越来	rlqk
越来越	rqr
联合	bkao
共同	amnt
报告	jpkg
设备	uown
过程中	jmo
看着	jmmm
目的	mmus
帮助	kpgs
资料	efkk
试验	ulza
来自	qkcm
人类	irkd
心情	cxyl
确定	tmat
劳动	xsas
医院	jepa
原则	zuda
办法	smvh
来了	qkdj
负责	ifmd
统计	spuy
昨天	fktd
是不是	fmf
左右	gvgo
下来	oxqk
心里	cxhl
最好	fbxi
受到	exth
考虑	evqc
有时	gkfj
速度	gorh
说明	ukfk
反应	zxrz
老师	elat
消费	veca
采取	egbx
很好	dkxi
行政	dltr
事业	jooy
谢谢	upup
卫生	ptcm
特点	qhit
身体	psig
范围	pezw
状态	qddu
从而	iiti
一条	tywg
之一	gzty
降低	pwip
具体	gmig
平均	hkhs
现象	euex
声音	rswf
一定要	tad
还要	mrdx
可爱	jkeg
素质	mszy
体系	igcs
介绍	iasm
表明	mqfk
给你	saim
力量	slft
他说	iuuk
世纪	usse
显示	fons
于是	hyft
行业	dloy
观察	xuab
不得	mbdf
手术	jsgu
意识	wfuo
时代	fjmd
机制	gnqn
旅游	tcvt
实行	aodl
下午	oxqw
以前	byqx
找到	jlth
体育	igpk
自由	cmey
妈妈	xzxz
联系	bkcs
而不	timb
良好	ukxi
关键	kdlb
肿瘤	kofp
这次	wref
汽车	vayc
拥有	jjgk
业务	oyws
他们的	iiu
大量	ddft
重视	ahdu
想到	gmth
这就	wrxv
爱你	egim
下去	oxhv
出了	vcdj
感到	ltth
交通	prsj
利益	maqm
都没	epvo
未来	qwqk
除了	pvdj
带来	maqk
离开	wzth
电视	fidu
当时	ebfj
认真	uiyg
记得	uedf
来说	qkuk
困难	zgxy
首先	qcqa
方向	tfuo
讨论	ujui
新华	ndil
是什么	fic
空间	avnf
导致	ejth
游戏	vtxl
专家	wvaq
委员	mxod
指出	jlvc
民族	elte
先生	qacm
香港	mfva
明白	fkub
我说	jluk
二十	weys
今晚	idfm
显著	fohe
为主	espz
病人	ftir
现实	euao
特别是	qkf
规范	yupe
结束	skgo
也许	uyuq
合理	aoeh
宣传	atiw
指导	jlej
相关	gmkd
新闻	ndnb
表达	mqdr
党的	zaus
压力	zhsl
满足	vhbz
好像	xiie
家庭	aqrs
发表	nfmq
在一起	gtr
正确	trtm
先进	qaur
不少	mbms
很大	dkdd
年代	evmd
举行	zmdl
尤其	iumq
操作	joik
一位	tyiw
一句	tyso
以下	byox
神经	dfsb
金融	sjtn
生日	cmfr
也就	uyxv
之前	gzqx
理解	ehmj
无论	hiui
比赛	lbau
它们	alin
革命	cgao
本报讯	gju
习惯	exyo
年轻	evyb
增强	hkco
看见	jmuj
作品	ikoo
就要	xvdx
改善	ewmq
更加	xfwj
重庆	ahrd
持续	jhsy
肯定	rkat
领域	ishl
按照	jyfm
新华社	nid
期待	mkdh
模式	gilv
优势	iips
一声	tyrs
你也	imuy
死了	bldj
相当	gmeb
加入	wjcu
及其	ljmq
银行	lkdl
土地	hthu
年来	evqk
同学	ntzi
面对	tcxj
女孩	xnis
身边	pssr
感谢	ltup
超过	rmjr
行动	dlas
长期	ycmk
反映	zxft
居然	rpbu
组成	sgle
在这里	gwh
评价	uhii
下降	oxpw
故事	pwjo
明确	fktm
然而	buti
战略	ilnw
适应	arrz
职工	bovg
规划	yula
青年	lqev
需求	ztzu
值得	iydf
事实	joao
看了	jmdj
让你	uiim
怎样	kcgm
也可	uyjk
阶段	pido
出去	vchv
不再	mben
都要	epdx
相对	gmxj
药物	hsqs
完善	ajmq
最高	fbxg
绝对	smxj
曾经	kvsb
那样	lpgm
清楚	vlyd
扩大	jrdd
集中	ygov
用户	jyqh
晚安	fmya
几乎	njck
不管	mbna
执行	pzdl
出版	vctz
销售	leyo
音乐	wfpv
电脑	fikw
资产	efwc
哪里	olhl
诊断	uiki
证明	utfk
及时	ljfj
建议	bhuu
机关	gnkd
又是	xyft
恢复	ygef
丰富	kfap
重大	ahdd
即使	kpix
经常	sbzb
体制	igqn
语言	ucuy
似乎	ibck
圣诞	xhuc
想起	gmre
刚刚	nxnx
让人	uiir
想要	gmdx
就可	xvjk
台湾	vovr
到底	thrp
温度	vfrh
变成	rxle
它的	alus
商品	nsoo
上了	itdj
来看	qkjm
电子	fiiz
深入	vacu
浙江	vjvv
现场	euhl
培训	hwus
有利	gkma
人家	iraq
制定	qnat
工艺	vghg
民主	elpz
差异	mveh
感染	ltvk
美元	mdjy
属于	rchy
投入	jocu
高度	xgrh
另外	klbi
生物	cmqs
心中	cxov
强调	coun
新年	ndev
感情	ltyl
往往	dpdp
指标	jlgn
第一次	nte
回答	zona
看来	jmqk
连续	yrsy
成了	ledj
规模	yugi
都会	epia
不一	mbty
方案	tfyg
加油	wjve
欢迎	xfpp
手段	jsdo
必要	ccdx
普通	qosj
物质	qszy
意见	wfuj
观念	xuid
位置	iwcy
时期	fjmk
会有	iagk
死亡	blpw
出口	vcok
实在	aogh
成本	legt
期间	mknf
你说	imuk
同样	ntgm
你就	imxv
做到	ipth
收入	ywcu
品种	oomo
地位	huiw
难以	xyby
广大	rgdd
资本	efgt
失去	eshv
消息	vecm
其它	mqal
照片	fmtp
美丽	mdtn
解释	mjck
国有	zegk
愿意	zuwf
加工	wjvg
不敢	mbdb
考试	evul
迅速	gygo
面积	tcmo
特征	qhdt
检测	gavd
才是	jcft
一部	tywo
不出	mbvc
复杂	efkg
中华	ovil
对象	xjex
看不	jmmb
年龄	evrz
我看	jljm
那一	lpty
听到	odth
那里	lphl
并且	qhgq
有一个	gti
对方	xjtf
那是	lpft
广泛	rgvc
儿童	aewh
过来	jrqk
还在	mrgh
后来	koqk
体现	igeu
状况	qdeo
做好	ipxi
中国人	ozi
儿子	aeiz
相互	gmto
自我	cmjl
犯罪	qecb
一件	tyiq
每次	eoef
交流	prvp
自身	cmps
严格	ocgw
都在	epgh
不足	mbbz
符合	niao
图片	zwtp
一张	tycy
道德	qcdy
成果	lefg
也会	uyia
作出	ikvc
成立	lewl
所谓	zrun
正是	trft
办公	smmv
文学	wwzi
对照	xjfm
安排	yajb
表面	mqtc
太多	dubb
适合	arao
职业	booy
星期	fcmk
加快	wjyt
态度	durh
父母	rfom
独立	qcwl
遇到	nnth
性能	ycvk
日子	friz
生态	cmdu
应当	rzeb
有什么	gic
你还	immr
含量	idft
在于	ghhy
疾病	feft
有个	gkiv
最后一	fkt
自动	cmas
评论	uhui
免疫	mofo
固定	zpat
主动	pzas
面前	tcqx
里面	hltc
痛苦	fshp
父亲	rfnq
令人	isir
回到	zoth
每年	eoev
她们	xuin
基础上	mti
程序	mors
情况下	yeo
较大	ypdd
生长	cmyc
转移	ywmb
不起	mbre
尽管	aena
动物	asqs
这时	wrfj
最终	fbsw
保障	iopo
落实	pwao
蛋白	drub
好多	xibb
各级	wgsl
母亲	omnq
市场经济	phsv
整体	gwig
开放	thtw
就像	xvie
是因为	fze
有限	gkpk
针对	lyxj
吃饭	oemz
基因	mhzd
症状	ftqd
推进	jyur
快来	ytqk
形象	thex
特殊	qhbq
软件	yfiq
家里	aqhl
名字	boai
主席	pzrh
今日	idfr
几年	njev
漂亮	vdxn
推动	jyas
客户	awqh
重新	ahnd
仍然	ilbu
上述	itgu
广州	rgsz
内部	knwo
马上	zmit
学会	ziia
真心	ygcx
和我	mojl
放弃	twph
一段	tydo
好看	xijm
一边	tysr
机械	gngl
那种	lpmo
缺乏	qtcg
不够	mbso
一家	tyaq
运行	ardl
商业	nsoy
巨大	jrdd
之中	gzov
模型	gita
不可能	mjv
文明	wwfk
关心	kdcx
一只	tyom
制造	qnkr
早上	fyit
突出	advc
本文	gtww
各地	wghu
区域	jxhl
当前	ebqx
风险	nfpa
追求	urzu
血管	cina
竟然	ojbu
一生	tycm
老人	elir
理想	ehgm
特色	qhmv
样子	gmiz
改造	ewkr
毕业	lyoy
书记	dpue
作者	ikez
国务	zews
掌握	zjjr
运用	arjy
美好	mdxi
也没有	uvg
成绩	lesm
主体	pzig
方便	tfix
给力	sasl
立即	wlkp
结婚	skxp
计算机	ung
施工	tuvg
双方	xxtf
我觉得	jzd
和平	mohk
训练	ussl
放在	twgh
有机	gkgn
检验	gaza
第四	ncza
爸爸	rvrv
年前	evqx
种子	moiz
一致	tyth
现代化	emi
抑制	jpqn
真实	ygao
皮肤	gpky
运输	arya
队伍	piic
再次	enef
就可以	xjb
了吗	djoz
近年	drev
英国	htze
广告	rgkg
事件	joiq
矛盾	sxzy
你要	imdx
要是	dxft
用于	jyhy
全球	sqez
本来	gtqk
姑娘	xpxu
正式	trlv
高兴	xgzm
人口	irok
过了	jrdj
分布	mfgb
数量	kxft
变得	rxdf
多种	bbmo
忘记	pcue
一片	tytp
给予	sasx
水声	zsrs
天气	tdaq
是由	ftey
走了	rzdj
进步	urrm
了个	djiv
难道	xyqc
错过	lajr
对不	xjmb
宝贝	aedb
优秀	iiml
信号	iuov
设施	uotu
审计	afuy
又不	xymb
解放	mjtw
享受	xiex
如果你	xfi
这就是	wxf
让他	uiiu
财政	djtr
充满	pavh
尤其是	imf
处于	wihy
逐步	qrrm
品牌	ootu
有所	gkzr
测定	vdat
更好	xfxi
下一	oxty
大多	ddbb
意思	wfnc
集团	ygzj
两国	zlze
是要	ftdx
道路	qcbw
微笑	fnnc
件事	iqjo
消失	vees
很有	dkgk
至少	tvms
规律	yudb
普遍	qoqi
集体	ygig
就好	xvxi
一项	tyvt
来到	qkth
药品	hsoo
感受	ltex
在家	ghaq
女儿	xnae
确实	tmao
当地	ebhu
公开	mvth
相应	gmrz
测试	vdul
一方	tytf
快速	ytgo
女性	xnyc
回去	zohv
居民	rpel
两人	zlir
国外	zebi
一场	tyhl
不如	mbxo
一会	tyia
维护	syjq
强烈	coba
营养	xomu
避免	rwmo
成熟	lexk
水泥	zsvr
坐在	iigh
那就	lpxv
站在	wigh
交易	prfs
免费	moca
温暖	vffe
带着	mamm
始终	xvsw
留下	pmox
破坏	tghm
大小	ddvx
太阳	dupf
不懂	mbyh
文章	wwoz
依然	ipbu
亲爱	nqeg
逐渐	qrvy
经历	sbzs
兄弟	oakc
贷款	mdhn
效益	prqm
感动	ltas
就能	xvvk
比例	lbib
如今	xoid
推广	jyrg
就算	xvnm
天下	tdox
精彩	kleg
世界上	uni
一份	tyim
两种	zlmo
打开	jxth
医生	jecm
污染	vwvk
本身	gtps
是谁	ftuy
上班	itey
协调	ysun
概念	gkid
保险	iopa
杭州	gpsz
贯彻	oddl
做了	ipdj
疗效	fdpr
见到	ujth
法国	vhze
形势	thps
总统	kosp
阳光	pfet
国民	zeel
同一	ntty
这位	wriw
休息	igcm
国务院	zwp
人物	irqs
唯一	oyty
大力	ddsl
构成	gsle
伟大	iwdd
委员会	moi
果然	fgbu
福建	dpbh
马克	zmpa
成员	leod
对他	xjiu
有利于	gmh
如下	xoox
很快	dkyt
从来	iiqk
情绪	ylse
某些	htrl
吸引	olcv
去看	hvjm
跟我	bkjl
好想	xigm
玻璃	egew
生存	cmgi
召开	mzth
有没	gkvo
刺激	gnvu
科研	mktt
投票	jodn
身上	psit
趋势	rmps
好吧	xiov
经济发展	svnr
多年	bbev
预防	sxpt
慢慢	yfyf
发出	nfvc
高校	xggp
讨厌	ujzd
亲爱的	neu
危险	mzpa
动作	asik
限制	pkqn
购买	dsdo
因而	zdti
脸上	kait
又有	xygk
斗争	kdmb
紧张	axcy
食品	fsoo
相同	gmnt
哲学	jdzi
相比	gmlb
很不	dkmb
德国	dyze
几天	njtd
很难	dkxy
防止	ptrz
满意	vhwf
近年来	deq
核心	gscx
体验	igza
总结	kosk
就业	xvoy
公路	mvbw
广东	rgyv
十二	yswe
收到	ywth
配合	deao
周围	nhzw
南京	xqxv
视频	durm
转变	ywrx
距离	bjwz
等待	nhdh
课程	ufmo
时尚	fjes
小心	vxcx
系列	csba
韩国	yyze
英语	htuc
表情	mqyl
数学	kxzi
贡献	vdxd
担心	jfcx
更新	xfnd
工人	vgir
女子	xniz
你看	imjm
又一	xyty
高速	xggo
一阵	typy
依据	ipjr
加大	wjdd
贸易	pmfs
要有	dxgk
还能	mrvk
一批	tyjl
当年	ebev
天天	tdtd
突破	adtg
欧洲	jxvs
提出了	jvd
可见	jkuj
必然	ccbu
错误	lauo
不愿	mbzu
勋章	odoz
呵呵	ojoj
有没有	gvg
山东	wsyv
忽然	sdbu
说道	ukqc
的确	ustm
各项	wgvt
说了	ukdj
损失	joes
主要是	pdf
也可以	ujb
各位	wgiw
不行	mbdl
理由	ehey
咖啡	owob
祝福	dodp
强度	corh
和你	moim
合同	aont
呼吸	ocol
网上	nxit
角度	mjrh
分子	mfiz
对你	xjim
动力	assl
记忆	ueyg
老板	elgz
医学	jezi
探索	jaya
出发	vcnf
吃了	oedj
医疗	jefd
我知道	jeq
反对	zxxj
在此	ghrl
内心	kncx
损伤	joie
告诉我	kuj
都没有	evg
平衡	hkdm
空气	avaq
成长	leyc
移动	mbas
我自	jlcm
决策	etng
获得了	hdd
推出	jyvc
调节	unhp
发布	nfgb
效率	prps
上升	itch
记录	uebz
头发	otnf
此时	rlfj
准确	eytm
挑战	jeil
得很	dfdk
文件	wwiq
数字	kxai
著名	hebo
有意	gkwf
今后	idko
冬天	wetd
媒体	xhig
彻底	dlrp
党员	zaod
基地	mhhu
案件	ygiq
就没	xvvo
化学	ilzi
总理	koeh
而已	tiey
杂志	kghc
吸收	olyw
否则	moda
主义	pzux
类型	kdta
基金	mhsj
此外	rlbi
小说	vxuk
抓住	jrip
学院	zipa
提供了	jid
小姐	vxxg
有奖	gkqb
承认	dzui
狮子	qtiz
也很	uydk
估计	ipuy
一眼	tymk
最佳	fbib
思维	ncsy
依法	ipvh
加上	wjit
观点	xuit
一口	tyok
完了	ajdj
教授	eije
西方	dxtf
公共	mvam
是很	ftdk
姐姐	xgxg
回忆	zoyg
说谎	ukuh
文艺	wwhg
但我	ifjl
先后	qako
防治	ptvv
老婆	elvg
思考	ncev
费用	cajy
公里	mvhl
全省	sqmm
专门	wvnm
无聊	hibp
妇女	xbxn
一面	tytc
小学	vxzi
完美	ajmd
两年	zlev
病例	ftib
忘了	pcdj
上午	itqw
刚才	nxjc
申请	fvul
看出	jmvc
大型	ddta
客观	awxu
浓度	vbrh
住宅	ipac
三十	csys
为此	esrl
较高	ypxg
一旦	tyft
学术	zigu
不必	mbcc
探讨	jauj
举办	zmsm
强大	codd
权利	gxma
纤维	sasy
在哪	ghol
接触	jwmj
战争	ilmb
经典	sbna
一时	tyfj
房间	qtnf
主题	pzfr
都能	epvk
同意	ntwf
女生	xncm
阳性	pfyc
平方	hktf
各个	wgiv
那时	lpfj
后面	kotc
是我们	fji
社区	dhjx
梦想	ybgm
创作	jaik
消费者	vce
伤害	ieak
学者	ziez
中间	ovnf
深刻	vasa
我又	jlxy
四个	zaiv
要去	dxhv
比如	lbxo
你想	imgm
取得了	bdd
一块	tyht
胜利	kcma
产量	wcft
更是	xfft
不见	mbuj
还没有	mvg
并没	qhvo
珍惜	eiya
再也	enuy
说是	ukft
完整	ajgw
鼓励	kqzt
图书	zwdp
买了	dodj
苹果	hhfg
或许	louq
懂得	yhdf
人士	irhs
宝宝	aeae
这是一	wft
大会	ddia
学科	zimk
确保	tmio
测量	vdft
组合	sgao
直到	ygth
公安	mvya
似的	ibus
病理	fteh
热情	ptyl
上面	ittc
失败	esdw
面临	tcan
赶紧	rhax
改革开放	ectt
即可	kpjk
对外	xjbi
小孩	vxis
一半	tycb
每一个	eti
什么时候	icfi
权力	gxsl
昨晚	fkfm
寻找	bjjl
大部	ddwo
是的	ftus
每个人	eii
江苏	vvhs
邓小平	xvh
并不是	qmf
马克思	zpn
第一个	nti
通知	sjeo
讲话	uuua
个性	ivyc
百分	tfmf
从事	iijo
等你	nhim
自觉	cmzu
英雄	htgv
典型	nata
活性	vayc
西部	dxwo
笔者	nqez
却不	hvmb
引导	cvej
深圳	vahs
引进	cvur
密切	aclm
不喜	mbkq
指数	jlkx
病毒	ftmo
这也	wruy
又要	xydx
兴趣	zmrb
涉及	vrlj
就是这	xfw
参数	vdkx
是以	ftby
咱们	ocin
法规	vhyu
访问	utno
附近	pidr
明年	fkev
显得	fodf
事故	jopw
局部	rewo
眼前	mkqx
一步	tyrm
既然	kibu
我家	jlaq
条件下	wio
一系	tycs
基层	mhra
和他	moiu
强化	coil
国人	zeir
他就	iuxv
市民	pbel
异常	ehzb
起床	rerg
立刻	wlsa
怎么办	kcs
日前	frqx
上有	itgk
给了	sadj
把握	jvjr
房子	qtiz
发病	nfft
流行	vpdl
妻子	ybiz
办公室	sma
工具	vggm
中午	ovqw
全市	sqpb
多么	bbcv
执法	pzvh
可惜	jkya
升级	chsl
制作	qnik
上市	itpb
可怜	jkyi
承担	dzjf
进口	urok
要把	dxjv
好不	ximb
食物	fsqs
不明	mbfk
绿色	sbmv
辛苦	wxhp
路上	bwit
三国	csze
适当	areb
却是	hvft
出现了	ved
我喜欢	jkx
设置	uocy
读者	uyez
对此	xjrl
江泽民	vve
飞机	gegn
生日快乐	cfyp
有时候	gfi
力度	slrh
文献	wwxd
淋巴	vyvb
上下	itox
实力	aosl
做出	ipvc
把这	jvwr
主人	pzir
一辈	tyby
部位	woiw
走出	rzvc
好吃	xioe
冠军	ajay
发达	nfdr
接着	jwmm
下面	oxtc
常常	zbzb
高等	xgnh
例如	ibxo
新浪	ndvu
颜色	wcmv
祖国	dgze
部队	wopi
有关部门	gkwn
处女	wixn
协议	ysuu
粮食	kufs
三年	csev
神马	dfzm
并没有	qvg
一系列	tcb
粉丝	kmss
判断	caki
不住	mbip
外面	bitc
宣布	atgb
植物	gyqs
这样一	wgt
实际上	api
物理	qseh
由此	eyrl
使得	ixdf
中学	ovzi
平安	hkya
不但	mbif
全身	sqps
得到了	dtd
个体	ivig
结论	skui
有感	gklt
男子	nsiz
性质	yczy
青春	lquf
血液	civp
但不	ifmb
句话	soua
最重	fbah
可能是	jvf
节目	hpmm
风格	nfgw
福州	dpsz
改进	ewur
是为了	fed
走向	rzuo
射手	pjjs
帮我	kpjl
一辈子	tbi
轻松	ybgm
一部分	twm
等方面	ntt
舒服	apkp
大学生	dzc
共产	amwc
军事	ayjo
拒绝	jjsm
标志	gnhc
总有	kogk
两天	zltd
寂寞	avai
上来	itqk
考察	evab
中医	ovje
外国	bize
看过	jmjr
四川	zasc
分为	mfes
战斗	ilkd
足球	bzez
对不起	xmr
安装	yaqh
流动	vpas
是指	ftjl
害怕	akyu
分离	mfwz
尊重	qjah
恋爱	rceg
想象	gmex
是这样	fwg
不喜欢	mkx
较好	ypxi
显然	fobu
那么多	lcb
中共	ovam
夫人	yfir
味道	oqqc
成分	lemf
允许	vauq
乡镇	scly
美女	mdxn
恐怖	vnyg
循环	dzem
起了	redj
反正	zxtr
各国	wgze
上海市	ivp
一百	tytf
轻轻	ybyb
笑了	ncdj
党委	zamx
途径	vrdb
切除	lmpv
至今	tvid
最新	fbnd
作业	ikoy
说出	ukvc
才会	jcia
我已经	jes
超级	rmsl
位于	iwhy
已成	eyle
哥哥	jjjj
纪念	seid
领导干部	iehw
手中	jsov
出门	vcnm
我们在	jig
前面	qxtc
工资	vgef
部长	woyc
短信	etiu
它是	alft
背景	klfx
老公	elmv
第五	nccw
主任	pzis
高于	xghy
各类	wgkd
多次	bbef
情感	yllt
礼物	diqs
人大	irdd
我心	jlcx
道理	qceh
时刻	fjsa
特性	qhyc
与其	symq
打电话	jfu
听说	oduk
熟悉	xkck
尼玛	rlez
总体	koig
重复	ahef
也在	uygh
优化	iiil
可靠	jkkb
接近	jwdr
即将	kpqb
激动	vuas
分配	mfde
可怕	jkyu
早期	fymk
没有人	vgi
会计	iauy
切实	lmao
大部分	dwm
真不	ygmb
让我们	uji
团结	zjsk
之外	gzbi
通常	sjzb
合格	aogw
本人	gtir
好运	xiar
十五	yscw
员工	odvg
规则	yuda
身份	psim
家长	aqyc
常规	zbyu
坚决	axet
但他	ifiu
地球	huez
成就	lexv
效应	prrz
也就是	uxf
要在	dxgh
俄罗斯	icm
他还	iumr
少年	msev
最重要	fad
最爱	fbeg
看得	jmdf
传播	iwjc
好久	ximu
协会	ysia
是从	ftii
走到	rzth
毫无	xqhi
供应	iarz
在这个	gwi
一路	tybw
河南	vjxq
奇怪	djyx
互相	togm
这几	wrnj
彼此	dgrl
新款	ndhn
方针	tfly
关节	kdhp
目光	mmet
心脏	cxkr
适用	arjy
欣赏	dfzd
障碍	potf
联合国	baz
少数	mskx
文字	wwai
我们都	jie
简直	nnyg
高级	xgsl
做法	ipvh
友好	gxxi
近日	drfr
小组	vxsg
一方面	ttt
垃圾	hwhl
网站	nxwi
早已	fyey
好友	xigx
仿佛	itic
来源	qkvz
一道	tyqc
哪个	oliv
都很	epdk
个小时	ivf
美的	mdus
环节	emhp
双鱼	xxry
而不是	tmf
义务	uxws
形态	thdu
奖励	qbzt
还会	mria
坚强	axco
究竟	akoj
试试	ulul
动态	asdu
单纯	kfsl
十一	ysty
大概	ddgk
见过	ujjr
天津	tdvb
注射	vppj
个字	ivai
有可能	gjv
话说	uauk
作了	ikdj
床上	rgit
金牛	sjqn
丈夫	xzyf
葡萄	hshs
不容	mbaw
注重	vpah
公布	mvgb
毛泽东	qvy
聪明	bkfk
敏感	eolt
没想	vogm
优惠	iihf
生理	cmeh
眼泪	mkvm
地下	huox
随时	pgfj
出血	vcci
不合	mbao
明明	fkfk
另一个	kti
跟你	bkim
男女	nsxn
人民日报	iefj
打算	jxnm
不良	mbuk
平台	hkvo
心灵	cxbw
铁路	lebw
也不会	umi
主持	pzjh
这件	wriq
有一天	gtt
上去	ithv
转化	ywil
发育	nfpk
所在	zrgh
打击	jxhz
下载	oxyl
亚洲	oyvs
出版社	vtd
旅行	tcdl
有一种	gtm
不清	mbvl
双手	xxjs
批评	jluh
不得不	mdm
应该是	ruf
兴奋	zmdn
要做	dxip
付出	ijvc
消除	vepv
观众	xuii
研究所	taz
下了	oxdj
新型	ndta
我现在	jeg
司法	etvh
依靠	ipkb
实用	aojy
得好	dfxi
具备	gmwn
走过	rzjr
人体	irig
反复	zxef
不停	mbix
嘿嘿	odod
咨询	efus
黑色	dhmv
不需	mbzt
维持	syjh
千万	aqte
只好	omxi
高中	xgov
过年	jrev
肚子	khiz
骨折	ygjd
很高	dkxg
把它	jval
意味	wfoq
加以	wjby
疼痛	fwfs
那天	lptd
天秤	tdmh
生气	cmaq
春节	ufhp
十年	ysev
环保	emio
之所	gzzr
消化	veil
建成	bhle
其次	mqef
房地	qthu
这么多	wcb
停止	ixrz
色彩	mveg
明星	fkfc
在外	ghbi
预测	sxvd
印度	pprh
最低	fbip
优质	iizy
一看	tyjm
监测	anvd
什么事	icj
中国人民	ozie
采访	egut
首次	qcef
一定会	tai
减轻	elyb
发动	nfas
白羊	ubmy
前提	qxjf
警察	hwab
现有	eugk
达人	drir
进去	urhv
家人	aqir
两个人	zii
批准	jley
不久	mbmu
进展	urra
怀疑	ymle
绝不	smmb
负责人	imi
混合	vfao
一会儿	tia
中药	ovhs
职能	bovk
淘宝	vsae
了啊	djop
人工	irvg
股份	koim
更大	xfdd
称为	mmes
羡慕	meiv
房地产	qhw
外交	bipr
旁边	wtsr
长大	ycdd
我自己	jce
收费	ywca
减肥	elkv
智能	eovk
一套	tydd
错了	ladj
市政	pbtr
资格	efgw
争取	mbbx
一颗	tyfg
还可以	mjb
天然	tdbu
某种	htmo
前后	qxko
利润	mavn
没事	vojo
设立	uowl
命运	aoar
提前	jfqx
路线	bwst
感冒	ltfm
补充	pipa
都可以	ejb
信用	iujy
他也	iuuy
发行	nfdl
病变	ftrx
损害	joak
走进	rzur
各自	wgcm
怎么样	kcg
麻烦	rywt
浪费	vuca
定位	atiw
很少	dkms
也能	uyvk
并非	qhbf
本质	gtzy
跟着	bkmm
装置	qhcy
城镇	hlly
发生了	ncd
摄影	jbfv
提示	jfns
笑道	ncqc
大多数	dbk
娱乐	xopv
东方	yvtf
证实	utao
更为	xfes
反而	zxti
一体	tyig
一九	tykj
看到了	jtd
更有	xfgk
类似	kdib
加速	wjgo
让她	uixu
我们要	jid
表演	mqva
一笑	tync
足够	bzso
武汉	tlvx
平方米	htk
连接	yrjw
另一方面	kttt
氧化	amil
光棍	etgf
但在	ifgh
还好	mrxi
厦门	ztnm
则是	daft
了什么	dic
金属	sjrc
最多	fbbb
温柔	vfsx
这儿	wrae
想法	gmvh
将在	qbgh
发展中	nro
指挥	jlja
体会	igia
层次	raef
生活中	cvo
宗教	anei
治理	vveh
曲线	fast
笑容	ncaw
看完	jmaj
一句话	tsu
便是	ixft
风景	nffx
朝鲜	yyrm
早就	fyxv
周年	nhev
输出	yavc
立法	wlvh
信心	iucx
湖南	vpxq
秘密	mcac
饲料	mekk
提醒	jfdf
恶性	ocyc
尽量	aeft
这张	wrcy
白色	ubmv
进来	urqk
车辆	ycyz
望着	pkmm
但这	ifwr
通信	sjiu
出席	vcrh
进程	urmo
形成了	tld
真好	ygxi
生产力	cws
每日	eofr
公民	mvel
化疗	ilfd
包装	sbqh
沉默	vadd
树立	gxwl
老年	elev
参考	vdev
演出	vavc
右边	gosr
很久	dkmu
敌人	awir
违法	wpvh
流量	vpft
急性	mbyc
放下	twox
经济效益	svpq
周期	nhmk
我省	jlmm
为何	esij
机遇	gnnn
用来	jyqk
展开	rath
尽快	aeyt
人群	irbc
极大	gldd
难过	xyjr
衣服	pykp
原理	zueh
作家	ikaq
不对	mbxj
你们的	iiu
初步	pmrm
星座	fcri
链接	lyjw
区别	jxka
启动	qoas
法制	vhqn
放心	twcx
人数	irkx
以上的	biu
在内	ghkn
收集	ywyg
危机	mzgn
是非	ftbf
这一点	wti
编辑	sqyo
照顾	fmze
不完	mbaj
回头	zoot
剂量	waft
宿舍	aiap
至于	tvhy
如果我	xfj
并发	qhnf
贫困	mdzg
厉害	ztak
半年	cbev
秩序	mers
能量	vkft
还真	mryg
联通	bksj
有力	gksl
等着	nhmm
默默	dddd
财产	djwc
眼神	mkdf
范围内	pzk
幸运	hqar
也不是	umf
科学技术	mzjg
不太	mbdu
浪漫	vuvf
心肌	cxkn
将会	qbia
时光	fjet
而在	tigh
通讯	sjug
种植	mogy
研制	ttqn
事物	joqs
独特	qcqh
一代	tymd
下次	oxef
愿望	zupk
读书	uydp
提高了	jxd
也是一	uft
几十	njys
较为	ypes
不爱	mbeg
纷纷	smsm
一分	tymf
监察	anab
会见	iauj
也只	uyom
造型	krta
领导人	iei
真的是	yuf
休闲	igng
岗位	wniw
自行	cmdl
不适	mbar
日益	frqm
评估	uhip
公平	mvhk
后悔	koye
是怎么	fkc
受伤	exie
模糊	gikp
因子	zdiz
博文	yjww
收藏	ywhl
答案	nayg
地面	hutc
无限	hipk
自主	cmpz
展示	rans
密度	acrh
基于	mhhy
个方面	itt
男生	nscm
复合	efao
考核	evgs
完成了	ald
上网	itnx
众多	iibb
我爱你	jei
工作中	vio
提升	jfch
月份	kyim
背后	klko
主管	pzna
正品	troo
机器	gnoo
交换	prjm
低于	iphy
智慧	eokk
鉴定	anat
品质	oozy
装饰	qhme
逻辑	cbyo
长江	ycvv
可以说	jbu
当我	ebjl
频率	rmps
不怕	mbyu
自信	cmiu
有你	gkim
将来	qbqk
不一样	mtg
全世界	sun
伤心	iecx
不开	mbth
有感而发	gltn
之下	gzox
会在	iagh
爱我	egjl
性格	ycgw
会不会	imi
邀请	uwul
住了	ipdj
就这样	xwg
系数	cskx
体内	igkn
不下	mbox
妹妹	xqxq
拿出	aovc
勇气	sjaq
多数	bbkx
腐败	ridw
什么样	icg
男孩	nsis
常见	zbuj
门口	nmok
锻炼	ldwl
整理	gweh
上课	ituf
年底	evrp
对待	xjdh
意外	wfbi
说什么	uic
奋斗	dnkd
成都	leep
同事	ntjo
理性	ehyc
有一定	gta
思路	ncbw
我把	jljv
神秘	dfmc
输入	yacu
一支	tyyx
配置	decy
前进	qxur
围绕	zwsl
血清	civl
你知道	ieq
配套	dedd
深深	vava
尚未	esqw
没想到	vgt
男性	nsyc
各方	wgtf
负担	ifjf
也不能	umv
一座	tyri
群体	bcig
货币	ilcb
转换	ywjm
平时	hkfj
忍不住	mmi
干嘛	hgor
住房	ipqt
爱上	egit
少女	msxn
深化	vail
想吃	gmoe
想想	gmgm
红色	svmv
没看	vojm
真相	yggm
技能	jyvk
告诉你	kui
这条	wrwg
两次	zlef
新鲜	ndrm
财务	djws
老大	eldd
在学	ghzi
依赖	ipgo
好几	xinj
分类	mfkd
不需要	mzd
和谐	moul
不然	mbbu
对她	xjxu
承诺	dzuh
想说	gmuk
要不要	dmd
人心	ircx
外套	bidd
全体	sqig
很想	dkgm
修改	iwew
无所	hizr
落后	pwko
等级	nhsl
宏观	agxu
水果	zsfg
从此	iirl
才有	jcgk
此次	rlef
单身	kfps
人民群众	iebi
冲击	eohz
我就是	jxf
当你	ebim
工商	vgns
活力	vasl
没什么	vic
也想	uygm
新年快乐	neyp
作风	iknf
感恩	ltzd
惊喜	yxkq
起到	reth
仅仅	ixix
手指	jsjl
到现在	teg
一直在	tyg
商务	nsws
信任	iuis
坚定	axat
在一个	gti
帮忙	kpyp
国内外	zkb
一本	tygt
角色	mjmv
动脉	asku
开了	thdj
随便	pgix
论文	uiww
武器	tloo
工作人员	viio
消防	vept
在那里	glh
恭喜	amkq
上帝	itwb
证券	utnm
印象	ppex
静脉	lmku
仔细	iisn
装备	qhwn
军队	aypi
官员	auod
黄金	aesj
无奈	hidn
答应	narz
剩下	mkox
意大利	wdm
对手	xjjs
课题	uffr
保健	ioib
说得	ukdf
通道	sjqc
陌生	ptcm
伤不起	imr
送给	kdsa
染色	vkmv
国有企业	zgio
据说	jruk
得出	dfvc
慢性	yfyc
发言	nfuy
危害	mzak
恶心	occx
相结合	gsa
问道	noqc
要我	dxjl
新生	ndcm
紧紧	axax
大陆	ddph
合法	aovh
了一些	dtr
登记	btue
体重	igah
建材	bhgj
失望	espk
教材	eigj
年后	evko
在下	ghox
一篇	tynq
服装	kpqh
共产党	awz
森林	gyyl
创意	jawf
阅读	nkuy
再说	enuk
三个代表	cimm
搞好	jxxi
浙江省	vvm
取消	bxve
近期	drmk
要看	dxjm
不利	mbma
开口	thok
合成	aole
民间	elnf
谢谢你	uui
蔬菜	hrhe
人均	irhs
主张	pzcy
等到	nhth
你妹	imxq
不成	mble
婚姻	xpxz
两岸	zlwz
监管	anna
证据	utjr
毕竟	lyoj
予以	sxby
伊拉克	ijp
北京市	kxp
室内	atkn
详细	umsn
疯狂	fnqe
克服	pakp
一个月	tik
某人	htir
高效	xgpr
玉米	eukm
一群	tybc
出生	vccm
原料	zukk
人民币	iec
覆盖	ddmi
威胁	ltks
好玩	xiej
公斤	mvdj
不安	mbya
更不	xfmb
合并	aoqh
早安	fyya
这才	wrjc
制约	qnss
支付	yxij
如图	xozw
对比	xjlb
激烈	vuba
牛奶	qnxl
并在	qhgh
司机	etgn
火车	whyc
家伙	aqiw
得了	dfdj
两位	zliw
这句	wrso
差距	mvbj
灵魂	bwau
有些人	gri
看起来	jrq
能否	vkmo
你来	imqk
清晰	vlfg
公主	mvpz
收获	ywhq
增大	hkdd
向前	uoqx
传说	iwuk
摩羯	rymf
呈现	oeeu
太好	duxi
图书馆	zdm
缓解	semj
我可以	jjb
模拟	gijb
现状	euqd
原文	zuww
欢乐	xfpv
均匀	hsse
马克思主义	zpnu
承受	dzex
种种	momo
我没有	jvg
意味着	wom
之处	gzwi
渐渐	vyvy
某一	htty
不让	mbui
气氛	aqam
面向	tcuo
为他	esiu
股票	kodn
渠道	vjqc
较多	ypbb
搭配	jhde
遗传	criw
双子	xxiz
遗憾	cryl
积累	mons
毛主席	qpr
大队	ddpi
年度	evrh
大人	ddir
积极性	mgy
相似	gmib
故意	pwwf
升高	chxg
没有什么	vgic
办理	smeh
含有	idgk
果断	fgki
口气	okaq
地点	huit
我们这	jiw
见面	ujtc
选用	qajy
哭了	oodj
怀念	ymid
内涵	knvd
或是	loft
沟通	vssj
村民	gjel
营销	xole
健全	ibsq
能在	vkgh
天空	tdav
用药	jyhs
记住	ueip
建立了	bwd
难受	xyex
已成为	ele
你自己	ice
您的	imus
大师	ddat
以往	bydp
当代	ebmd
古代	pgmd
校园	gpzj
有爱	gkeg
孤独	irqc
老子	eliz
大哥	ddjj
经理	sbeh
伸出	ifvc
中小学	ovz
脂肪	klkt
故障	pwpo
湖北	vpkl
扩散	jrak
等于	nhhy
穿着	atmm
我不是	jmf
增加了	hwd
选项	qavt
注册	vpsc
十几	ysnj
有机会	ggi
青少年	lme
在其	ghmq
居住	rpip
岁月	wbky
所需	zrzt
心态	cxdu
非典	bfna
报纸	jpsp
最有	fbgk
工作者	vie
总之	kogz
创业	jaoy
抓好	jrxi
能不能	vmv
自治	cmvv
将军	qbay
难得	xydf
干扰	hgji
就把	xvjv
条例	wgib
冲突	eoad
西安	dxya
十六	yspm
打了	jxdj
不高	mbxg
平等	hknh
办事	smjo
活着	vamm
在哪里	goh
大声	ddrs
充分发挥	pmnj
存在着	ggm
周末	nhqm
演员	vaod
一杯	tygm
地理	hueh
一股	tyko
肌肉	knki
得多	dfbb
大奖	ddqb
不论	mbui
本地	gthu
很重	dkah
三天	cstd
身子	psiz
幼儿	ssae
大于	ddhy
经费	sbca
东北	yvkl
有限公司	gpme
表现为	mee
就没有	xvg
有很多	gdb
示范	nspe
博士	yjhs
延长	cryc
不禁	mbyn
干净	hgem
一回	tyzo
年轻人	eyi
混凝土	veh
纠结	sysk
你我	imjl
土壤	hthp
无疑	hile
办学	smzi
貌似	quib
做什么	iic
云南	ayxq
随机	pggn
预计	sxuy
差不多	mmb
合适	aoar
早餐	fyix
这类	wrkd
酒店	vdri
醒来	dfqk
冬季	wemi
算了	nmdj
赶快	rhyt
这件事	wij
到处	thwi
保留	iopm
描述	jhgu
法院	vhpa
下班	oxey
电信	fiiu
主角	pzmj
优点	iiit
在乎	ghck
回归	zoab
振动	jzas
转身	ywps
爱国	egze
社会发展	dinr
之所以	gzb
承包	dzsb
带动	maas
快点	ytit
也无	uyhi
第六	ncpm
释放	cktw
无数	hikx
说着	ukmm
舞台	ebvo
不一定	mta
日常	frzb
理念	ehid
在我们	gji
担任	jfis
可持续	jjs
不准	mbey
安慰	yarj
孩子们	iii
以外	bybi
进了	urdj
看法	jmvh
眼光	mket
最美	fbmd
听见	oduj
给她	saxu
严肃	ocbm
从不	iimb
移民	mbel
也来	uyqk
便宜	ixag
演唱	vaof
广场	rghl
董事	hajo
不满	mbvh
他又	iuxy
灵活	bwva
大幅	ddbp
话题	uafr
季节	mihp
局面	retc
到来	thqk
中文	ovww
其余	mqvy
财富	djap
找不到	jmt
开拓	thjt
外资	bief
占有	izgk
石油	tsve
从来没	iqv
实验室	aza
一周	tynh
地铁	hule
流通	vpsj
激励	vuzt
为止	esrz
奶奶	xlxl
掉了	jidj
很可	dkjk
回事	zojo
实质	aozy
五十	cwys
交往	prdp
援助	jegs
安静	yalm
事实上	jai
不动	mbas
秘书	mcdp
露出	zbvc
所说	zruk
南方	xqtf
很多人	dbi
决不	etmb
策略	ngnw
平静	hklm
一刻	tysa
队员	piod
不该	mbus
暂时	ydfj
让自己	uce
投资者	jee
依旧	ipvf
一遍	tyqi
社会主义市场经济	dipv
战士	ilhs
透明	mlfk
好吗	xioz
当初	ebpm
持续发展	jsnr
事务	jows
原谅	zuux
可用	jkjy
狮子座	qir
相反	gmzx
得以	dfby
维生	sycm
早晨	fyfz
这对	wrxj
回回	zozo
小时候	vfi
复发	efnf
变形	rxth
练习	slex
从中	iiov
魅力	uasl
好听	xiod
表现出	mev
只见	omuj
定义	atux
发现了	ned
均为	hses
大事	ddjo
饮食	mffs
懂的	yhus
笑着	ncmm
请你	ulim
两者	zlez
亲自	nqcm
选举	qazm
热烈	ptba
重要的是	aduf
国民经济	zesv
约束	ssgo
倾向	iluo
白天	ubtd
尝试	eaul
有钱	gklt
再见	enuj
营业	xooy
推行	jydl
找到了	jtd
支撑	yxjz
不肯	mbrk
这个世界	wiun
算是	nmft
那儿	lpae
烦恼	wtyw
哪儿	olae
河北	vjkl
能源	vkvz
勇敢	sjdb
能有	vkgk
悲剧	bcrp
奥运	ukar
维生素	scm
五年	cwev
一身	typs
应有	rzgk
她就	xuxv
众人	iiir
局长	reyc
手里	jshl
消毒	vemo
半个	cbiv
四十	zays
武装	tlqh
轴承	yedz
这项	wrvt
更高	xfxg
我们就	jix
化妆	ilqx
无论是	huf
抱着	jsmm
市政府	ptr
工厂	vgzc
地震	huzz
仪式	iulv
课堂	ufzh
过去了	jhd
前景	qxfx
人格	irgw
我妈	jlxz
审批	afjl
报名	jpbo
天蝎	tdcf
境界	honi
愉快	yayt
姐妹	xgxq
黑暗	dhfw
房屋	qtrt
鸡蛋	xedr
向上	uoit
天蝎座	tcr
刑事	thjo
韩版	yytz
定期	atmk
收益	ywqm
大众	ddii
全是	sqft
想念	gmid
临时	anfj
好啊	xiop
潜力	vysl
拍摄	jujb
对着	xjmm
原本	zugt
陪我	pwjl
艰苦	xkhp
点点	itit
高达	xgdr
中华人民	oiie
十三	yscs
要素	dxms
大约	ddss
专用	wvjy
只不过	omj
分手	mfjs
公正	mvtr
初中	pmov
人文	irww
宇宙	ahae
生成	cmle
这部	wrwo
首歌	qcjj
第二天	nwt
无人	hiir
多久	bbmu
喝酒	ofvd
内在	kngh
中华人民共和国	oiiz
个别	ivka
到底是	trf
爆炸	wfwk
远远	jrjr
命令	aois
一首	tyqc
运作	arik
脸色	kamv
如果有	xfg
新疆	ndch
个国家	iza
同期	ntmk
优良	iiuk
有助	gkgs
好奇	xidj
圣诞节	xuh
爆发	wfnf
选手	qajs
对话	xjua
可能会	jvi
怎么了	kcd
客人	awir
到达	thdr
清醒	vldf
扩张	jrcy
我能	jlvk
科学家	mza
使其	ixmq
过多	jrbb
现金	eusj
履行	rddl
出现在	veg
一辆	tyyz
非法	bfvh
画面	tntc
奖品	qboo
气质	aqzy
就是要	xfd
职责	bomd
注定	vpat
在世	ghus
一双	tyxx
回来了	zqd
怎么会	kci
把她	jvxu
代表团	mmz
仪器	iuoo
想着	gmmm
躺在	pegh
双子座	xir
只想	omgm
毕业生	loc
紧密	axac
外科	bimk
在前	ghqx
真空	ygav
这不是	wmf
增多	hkbb
街道	dbqc
交给	prsa
阻止	pgrz
中共中央	oaot
好事	xijo
驾驶	wzzo
着眼	mmmk
朋友们	kgi
声明	rsfk
谈判	uwca
海外	vebi
均有	hsgk
此刻	rlsa
一番	tyck
热销	ptle
人力	irsl
随后	pgko
收购	ywds
高速公路	xgmb
不容易	maf
以便	byix
副总	pako
都说	epuk
代理	mdeh
传递	iwkc
打破	jxtg
下雨	oxzy
运动员	aao
首都	qcep
半夜	cbpi
某个	htiv
安徽	yafs
多样	bbgm
巨蟹	jrmm
气候	aqir
程度上	mri
培育	hwpk
情人	ylir
龙年	glev
巨蟹座	jmr
失去了	ehd
一千	tyaq
翻译	cnux
友谊	gxua
小区	vxjx
缺少	qtms
从未	iiqw
这个人	wii
两组	zlsg
本次	gtef
而我	tijl
只会	omia
后果	kofg
将于	qbhy
干燥	hgwo
毫不	xqmb
正好	trxi
无关	hikd
后者	koez
蛋糕	drkm
赢得	pddf
不变	mbrx
差别	mvka
分化	mfil
恐惧	vnyg
好处	xiwi
哪一	olty
律师	dbat
装修	qhiw
这个问题	winf
山西	wsdx
护理	jqeh
嘻嘻	okok
全国人大	szid
也不知	ume
每个人都	eiie
廉政	rqtr
一定是	taf
高血压	xcz
普及	qolj
好心	xicx
这款	wrhn
一层	tyra
尺寸	acjc
那个人	lii
前一	qxty
有那么	glc
人为	ires
那位	lpiw
百分之	tmg
激情	vuyl
有我	gkjl
不理	mbeh
共有	amgk
缺陷	qtpm
带领	mais
饲养	memu
会上	iait
大门	ddnm
论坛	uiha
决心	etcx
会被	iapg
但也	ifuy
试点	ulit
会让	iaui
双鱼座	xrr
有多少	gbm
脑袋	kwmp
才知道	jeq
常委	zbmx
采购	egds
都好	epxi
包含	sbid
购物	dsqs
基础设施	mtut
实践中	abo
就想	xvgm
了么	djcv
长时	ycfj
澳门	vunm
谁也	uyuy
参观	vdxu
非洲	bfvs
用手	jyjs
玫瑰	eweu
结局	skre
西藏	dxhl
再也不	eum
写作	asik
基本上	mgi
防水	ptzs
阿拉	pjjw
预算	sxnm
身后	psko
代替	mdyy
上半	itcb
这句话	wsu
之际	gzpn
迎接	ppjw
恐怕	vnyu
有过	gkjr
情形	ylth
变成了	rld
遇见	nnuj
排除	jbpv
很喜欢	dkx
权益	gxqm
微微	fnfn
再加	enwj
病情	ftyl
国防	zept
保存	iogi
节约	hpss
实事	aojo
种类	mokd
弟弟	kckc
这段	wrdo
知名	eobo
保暖	iofe
深度	varh
太太	dudu
在线	ghst
要注意	dvw
总会	koia
已经不	esm
从小	iivx
最喜欢	fkx
若干	hghg
当事	ebjo
引发	cvnf
稳定性	may
场所	hlzr
机场	gnhl
金牛座	sqr
传染	iwvk
结果表明	sfmf
那你	lpim
多大	bbdd
受体	exig
开始了	txd
知道了	eqd
超越	rmrl
转向	ywuo
巴黎	vbms
受不了	emd
自己是	cef
我们是	jif
攻击	vwhz
号码	ovtz
江湖	vvvp
党组	zasg
原来是	zqf
一手	tyjs
人性	iryc
失恋	esrc
谈话	uwua
联盟	bkfk
校长	gpyc
反腐	zxri
精神文明	kdwf
顾客	zeaw
这家	wraq
巩固	vnzp
起身	reps
陪你	pwim
少了	msdj
研讨	ttuj
不过是	mjf
无效	hipr
度过	rhjr
一副	typa
住在	ipgh
同步	ntrm
与此	syrl
脑子	kwiz
放松	twgm
去找	hvjl
治愈	vvax
总量	koft
谁都	uyep
直径	ygdb
做人	ipir
代谢	mdup
确立	tmwl
人事	irjo
函数	dzkx
步伐	rmil
不幸	mbhq
要么	dxcv
厨房	ztqt
对了	xjdj
难度	xyrh
五个	cwiv
原始	zuxv
海洋	vevm
广播	rgjc
自从	cmii
聊天	bptd
灾害	awak
意义上	wui
到位	thiw
极为	gles
不像	mbie
最小	fbvx
团体	zjig
未能	qwvk
诱惑	umlo
倒是	itft
对应	xjrz
任何人	iii
手上	jsit
大胆	ddkf
东南	yvxq
收缩	ywsa
当天	ebtd
较低	ypip
天秤座	tmr
越来越多	rqrb
留在	pmgh
繁荣	ewxg
细菌	snhz
一丝	tyss
出租	vcmg
处罚	wicu
子宫	izao
高新	xgnd
站起	wire
就这么	xwc
特定	qhat
一日	tyfr
外部	biwo
领取	isbx
干什么	hic
找个	jliv
内外	knbi
要好	dxxi
确认	tmui
移植	mbgy
肿么	kocv
添加	vtwj
中国共产党	ozaz
分开	mfth
达成	drle
出台	vcvo
白羊座	umr
帮你	kpim
资本主义	egpu
有无	gkhi
脚步	khrm
偶尔	inmv
身材	psgj
肌肤	knky
就说	xvuk
如同	xont
搞笑	jxnc
优先	iiqa
共和	ammo
所致	zrth
说到	ukth
牺牲	qdqc
问题上	nfi
失眠	esme
等地	nhhu
三种	csmo
修复	iwef
拿着	aomm
蓝色	hamv
原有	zugk
随意	pgwf
模样	gigm
传来	iwqk
思想政治	ngtv
杂交	kgpr
眼中	mkov
去吧	hvov
放射	twpj
第二次	nwe
绝大	smdd
就不会	xmi
节日	hpfr
我们也	jiu
座谈	riuw
全县	sqgv
检察	gaab
继承	skdz
脾气	kuaq
神奇	dfdj
市长	pbyc
差点	mvit
产生了	wcd
这么一	wct
桃花	gehi
有助于	ggh
糖尿	krrz
阶级	pisl
跟他	bkiu
年纪	evse
离子	wziz
渴望	vfpk
天地	tdhu
有趣	gkrb
单一	kfty
已被	eypg
怎么说	kcu
消耗	veqq
经济建设	svbu
生意	cmwf
颗粒	fgkw
特价	qhii
当今	ebid
轻易	ybfs
辐射	yppj
与他	syiu
审美	afmd
在意	ghwf
缺点	qtit
糖尿病	krf
意志	wfhc
我不想	jmg
不平	mbhk
以色列	bmb
放入	twcu
融合	tnao
真诚	ygul
冲动	eoas
舒适	apar
高温	xgvf
有一些	gtr
透露	mlzb
活跃	vabc
长得	ycdf
喜欢你	kxi
不易	mbfs
加重	wjah
精度	klrh
不放	mbtw
美人	mdir
一下子	toi
可持续发展	jjsr
附属	pirc
不给	mbsa
就知道	xeq
调动	unas
无比	hilb
世上	usit
而来	tiqk
一行	tydl
禁止	ynrz
清理	vleh
全民	sqel
更好地	xxh
盯着	mxmm
疯了	fndj
去做	hvip
违反	wpzx
听了	oddj
长度	ycrh
蛋白质	duz
全新	sqnd
昨日	fkfr
经济增长	svhy
常用	zbjy
年内	evkn
耳朵	beng
党中央	zot
两条	zlwg
这方面	wtt
妈的	xzus
说完	ukaj
补偿	piie
竞争力	wms
发达国家	ndza
我们一起	jitr
前往	qxdp
善于	mqhy
不吃	mboe
第七	nclq
辽宁	djan
一级	tysl
样品	gmoo
创建	jabh
并发症	qnf
公园	mvzj
近几年	dne
不愿意	mzw
很重要	dad
立场	wlhl
亲切	nqlm
山区	wsjx
语文	ucww
没了	vodj
建造	bhkr
不会有	mig
就去	xvhv
官方	autf
我不知道	jmeq
以此	byrl
精品	kloo
权威	gxlt
当事人	eji
清洁	vlvk
问题是	nff
沉重	vaah
渗透	vvml
气温	aqvf
夫妻	yfyb
教训	eius
上次	itef
元素	jyms
航空	bpav
维修	syiw
走上	rzit
真理	ygeh
悲伤	bcie
北方	kltf
耕地	quhu
不就	mbxv
分散	mfak
获取	hqbx
互联	tobk
信息化	ici
大脑	ddkw
拥抱	jjjs
上学	itzi
促使	ibix
签订	naux
吃完	oeaj
只需	omzt
医药	jehs
弹性	ckyc
在这种	gwm
塑料	kkkk
当他	ebiu
包邮	sbep
又在	xygh
院校	pagp
半天	cbtd
不信	mbiu
已是	eyft
这可	wrjk
你又	imxy
部署	woce
巧克力	vps
放假	twir
长时间	yfn
接到	jwth
上涨	itvc
各部	wgwo
过得	jrdf
电力	fisl
动手	asjs
重要思想	adng
夜间	pinf
也应	uyrz
热点	ptit
最为	fbes
很不错	dml
忽视	sddu
这场	wrhl
股市	kopb
送到	kdth
点头	itot
就看	xvjm
展现	raeu
有事	gkjo
不回	mbzo
职务	bows
养殖	muby
当作	ebik
全都	sqep
过度	jrrh
气体	aqig
也都	uyep
火锅	whlo
夏天	tmtd
认识到	uut
带有	magk
标本	gngt
查看	gfjm
再生	encm
一口气	toa
是想	ftgm
善良	mquk
超市	rmpb
坑爹	hprb
一根	tygk
寿命	kjao
笑死	ncbl
越南	rlxq
爱人	egir
增高	hkxg
愤怒	yyxx
审查	afgf
市委	pbmx
游客	vtaw
分泌	mfvc
杀人	xgir
而成	tile
还得	mrdf
产权	wcgx
成效	lepr
大气	ddaq
双眼	xxmk
才不	jcmb
爱心	egcx
格局	gwre
高层	xgra
也太	uydu
运营	arxo
洗澡	vqvo
疗程	fdmo
误差	uomv
元旦	jyft
为什么不	eicm
乳腺	eiku
正如	trxo
产物	wcqs
了呢	djor
哪些	olrl
我不会	jmi
碰到	tqth
男的	nsus
经济学	svz
单元	kfjy
花园	hizj
原因是	zzf
那就是	lxf
留学	pmzi
女孩子	xii
诗人	uhir
有种	gkmo
成人	leir
不解	mbmj
指示	jlns
欧盟	jxfk
这一切	wtl
诱导	umej
个中	ivov
凌晨	ehfz
空调	avun
地质	huzy
唱歌	ofjj
认证	uiut
有许多	gub
血压	cizh
精力	klsl
前来	qxqk
解决了	med
激发	vunf
重组	ahsg
纪律	sedb
详情	umyl
互联网	tbn
淡淡	vwvw
吸烟	olwz
教练	eisl
主导	pzej
太大	dudd
却又	hvxy
淋巴结	vvs
大连	ddyr
中国队	ozp
纠正	sytr
累了	nsdj
性感	yclt
当中	ebov
所得	zrdf
金钱	sjlt
月亮	kyxn
假如	irxo
高手	xgjs
那边	lpsr
是啊	ftop
对策	xjng
富有	apgk
执政	pztr
作物	ikqs
一段时间	tdfn
认定	uiat
什么是	icf
厕所	zdzr
比重	lbah
可以看出	jbjv
这只	wrom
期望	mkpk
而又	tixy
历史上	zoi
纽约	soss
档案	geyg
紧急	axmb
个问题	inf
有这样	gwg
导演	ejva
抗体	jpig
百姓	tfxc
摆脱	jckk
为什么要	eicd
我所	jlzr
专利	wvma
我给	jlsa
布局	gbre
陷入	pmcu
大规模	dyg
正当	treb
用力	jysl
想知道	geq
心血	cxci
缓缓	sese
何必	ijcc
些什么	ric
委托	mxjc
爷爷	rprp
宪法	aqvh
鼻子	cmiz
豪华	xqil
多方	bbtf
子女	izxn
去吃	hvoe
统治	spvv
这也是	wuf
眼里	mkhl
球员	ezod
笔记	nque
过渡	jrvr
老妈	elxz
可能性	jvy
就是这样	xfwg
三峡	cswy
没有了	vgd
混乱	vfai
手续	jssy
无可	hijk
早点	fyit
监控	anja
一顿	tylz
专题	wvfr
清除	vlpv
不等	mbnh
专项	wvvt
住院	ippa
沈阳	vbpf
好转	xiyw
春天	uftd
多元	bbjy
三分	csmf
旋转	tdyw
总数	kokx
过分	jrmf
评选	uhqa
主办	pzsm
婴儿	ddae
拿到	aoth
狭窄	qyak
劳动力	xas
内地	knhu
铸造	lkkr
红包	svsb
志愿	hczu
做得	ipdf
能让	vkui
积分	momf
江西	vvdx
福利	dpma
厂家	zcaq
燃烧	wuwl
发明	nffk
肺癌	ktfo
合金	aosj
哎呀	ohot
会谈	iauw
社员	dhod
派出	vzvc
替代	yymd
整天	gwtd
现代化建设	emiu
就得	xvdf
收拾	ywja
老头	elot
发作	nfik
可使	jkix
电路	fibw
看上	jmit
庆祝	rddo
陕西	pydx
到家	thaq
一台	tyvo
政协	trys
拿起	aore
仍是	ilft
不及	mblj
应力	rzsl
屏幕	rqib
查处	gfwi
借鉴	iaan
各方面	wtt
他把	iujv
几次	njef
提取	jfbx
缓慢	seyf
遭到	afth
就被	xvpg
尽可	aejk
一脸	tyka
欲望	wfpk
才发现	jne
气象	aqex
顿时	lzfj
思念	ncid
缺血	qtci
啤酒	ouvd
开车	thyc
奉献	uhxd
一类	tykd
死人	blir
抱怨	jsbe
久了	mudj
窗口	auok
也将	uyqb
嗷嗷	ofof
从前	iiqx
伙伴	iwic
新增	ndhk
骄傲	zcif
没见	vouj
客户端	aqw
开幕	thib
夜晚	pifm
老百姓	etx
累计	nsuy
硬件	txiq
委屈	mxrv
公众	mvii
穿越	atrl
日起	frre
市场上	phi
轨道	ykqc
随访	pgut
增生	hkcm
结合起来	sarq
潮流	vyvp
真有	yggk
叫做	oyip
缩短	saet
悄悄	yeye
主观	pzxu
温馨	vfro
大地	ddhu
不顾	mbze
更重	xfah
手法	jsvh
无线	hist
体现了	ied
货物	ilqs
战胜	ilkc
一头	tyot
泰国	uzze
傻逼	iupr
之上	gzit
国产	zewc
城乡	hlsc
看不到	jmt
光棍节	egh
喝了	ofdj
辅助	yjgs
不算	mbnm
陶瓷	psef
纳入	skcu
够了	sodj
家族	aqte
上说	ituk
溶液	vavp
生态环境	cdeh
针刺	lygn
极其	glmq
眼镜	mklo
诉讼	udum
暴露	fazb
头痛	otfs
用心	jycx
回收	zoyw
短期	etmk
不宜	mbag
不明白	mfu
治安	vvya
美食	mdfs
飞行	gedl
就成	xvle
静静	lmlm
影片	fvtp
扩展	jrra
据悉	jrck
没错	vola
十四	ysza
地道	huqc
很容易	daf
做事	ipjo
俱乐部	ipw
我相信	jgi
不出来	mvq
扫描	jbjh
感觉到	lzt
提到	jfth
过于	jrhy
高等教育	xnep
排队	jbpi
招标	jmgn
股东	koyv
那只	lpom
要想	dxgm
十八	ysmb
信仰	iuip
驱动	zjas
展览	raan
图为	zwes
组建	sgbh
家具	aqgm
什么呢	ico
在后	ghko
接下	jwox
一件事	tij
就很	xvdk
伸手	ifjs
坐下	iiox
却没	hvvo
形状	thqd
再来	enqk
口味	okoq
你不是	imf
乃至	lntv
所有人	zgi
适宜	arag
加热	wjpt
好不好	xmx
很强	dkco
周边	nhsr
加拿大	wad
人气	iraq
二次	weef
事儿	joae
中西	ovdx
他自己	ice
会员	iaod
生动	cmas
西南	dxxq
不受	mbex
方程	tfmo
数据库	kjr
聚集	bxyg
节能	hpvk
听着	odmm
这首	wrqc
名称	bomm
但由于	ieh
回报	zojp
看这	jmwr
重要性	ady
边缘	srso
制品	qnoo
头上	otit
中毒	ovmo
集成	ygle
审判	afca
相机	gmgn
不断地	mkh
模块	giht
抓紧	jrax
名牌	botu
调控	unja
我市	jlpb
警方	hwtf
单独	kfqc
沿海	vnve
全场	sqhl
最初	fbpm
水分	zsmf
有用	gkjy
全力	sqsl
做个	ipiv
一流	tyvp
发生在	ncg
幅度	bprh
不稳	mbmm
我们可以	jijb
公务	mvws
这是一个	wfti
爱好	egxi
抬起	jvre
一夜	typi
实体	aoig
多云	bbay
素质教育	mzep
文物	wwqs
歌曲	jjfa
都不会	emi
会使	iaix
着重	mmah
高峰	xgww
是没有	fvg
第八	ncmb
年初	evpm
情侣	ylio
港口	vaok
无力	hisl
各有	wggk
重量	ahft
签到	nath
精心	klcx
联赛	bkau
既是	kift
细节	snhp
广西	rgdx
处在	wigh
舆论	uyui
三人	csir
感受到	let
让他们	uii
中奖	ovqb
发射	nfpj
要用	dxjy
机体	gnig
债务	imws
接待	jwdh
沙发	vmnf
划分	lamf
原价	zuii
不开心	mtc
响应	ourz
走在	rzgh
高新技术	xnjg
一向	tyuo
上级	itsl
这样一个	wgti
发送	nfkd
教室	eiat
尽可能	ajv
吻合	osao
你妈	imxz
诸多	uebb
小子	vxiz
影响力	fos
老爸	elrv
只剩	ommk
应对	rzxj
创造性	jky
四周	zanh
私人	mvir
主管部门	pnwn
整顿	gwlz
可行	jkdl
电流	fivp
干预	hgsx
不仅是	mif
三次	csef
小麦	vxmw
也不知道	umeq
啊哈	opoa
热水	ptzs
忽略	sdnw
将有	qbgk
实在是	agf
欧美	jxmd
不来	mbqk
神情	dfyl
视为	dues
盲目	pmmm
第二个	nwi
一堆	tyhy
同行	ntdl
太平	duhk
它不	almb
皇帝	uewb
为中心	eoc
算法	nmvh
几年来	neq
请求	ulzu
分解	mfmj
天使	tdix
帝国	wbze
优雅	iitx
演唱会	voi
等问题	nnf
著作	heik
不好意思	mxwn
一款	tyhn
统战	spil
之内	gzkn
睡在	magh
通用	sjjy
金额	sjaw
赔偿	dwie
官兵	audm
脆弱	kmce
到那	thlp
麻醉	rydp
气息	aqcm
小朋友	vkg
亏损	wvjo
价值观	iix
产业化	woi
围观	zwxu
证书	utdp
不可以	mjb
伤口	ieok
代价	mdii
较强	ypco
彩色	egmv
醒了	dfdj
线路	stbw
我们党	jiz
这种情况	wmye
小康	vxrb
抵抗	jpjp
已达	eydr
多好	bbxi
前列	qxba
发放	nftw
幻想	segm
步骤	rmzx
寻求	bjzu
按摩	jyry
运气	araq
封闭	bjnj
人次	iref
中华民族	oiet
好大	xidd
向我	uojl
镜头	loot
信贷	iumd
甜蜜	ahac
谈到	uwth
下岗	oxwn
打造	jxkr
冷冷	eiei
都想	epgm
图像	zwie
考验	evza
智力	eosl
是可以	fjb
激素	vums
人间	irnf
我希望	jxp
编制	sqqn
支出	yxvc
全家	sqaq
清新	vlnd
已在	eygh
霸气	zcaq
技巧	jyvv
体积	igmo
没有任何	vgii
之类	gzkd
会更	iaxf
来得	qkdf
并将	qhqb
未见	qwuj
这样做	wgi
重庆市	arp
妹子	xqiz
功夫	vsyf
招生	jmcm
奇迹	djrr
论述	uigu
呜呜	oeoe
几分	njmf
业绩	oysm
氛围	amzw
商业银行	nold
登陆	btph
谁的	uyus
面包	tcsb
招聘	jmbe
修身	iwps
西北	dxkl
前者	qxez
健身	ibps
得不到	dmt
存款	gihn
注入	vpcu
就让	xvui
高科技	xmj
脖子	kyiz
耐心	ticx
写了	asdj
取决	bxet
青岛	lqew
就是在	xfg
能做	vkip
记载	ueyl
用水	jyzs
侵略	ibnw
高考	xgev
容量	awft
平面	hktc
两只	zlom
党政	zatr
抬头	jvot
强制	coqn
电压	fizh
宁波	anvg
对面	xjtc
又能	xyvk
放开	twth
营造	xokr
石头	tsot
远离	jrwz
有益	gkqm
公式	mvlv
咳嗽	osog
可在	jkgh
但却	ifhv
凝聚	esbx
帅哥	abjj
天真	tdyg
热爱	pteg
头脑	otkw
苏联	hsbk
转载	ywyl
巴西	vbdx
封建	bjbh
黑龙	dhgl
达到了	dtd
福建省	dbm
新世纪	nus
泪水	vmzs
预期	sxmk
热闹	ptnp
许可	uqjk
否定	moat
冷静	eilm
框架	gjwg
重建	ahbh
厚度	zfrh
局限	repk
旅客	tcaw
光明	etfk
若是	hgft
篮球	naez
请问	ulno
低下	ipox
摩羯座	rmr
信念	iuid
艰难	xkxy
到哪	thol
点半	itcb
情节	ylhp
嫉妒	xfxq
回顾	zoze
身高	psxg
整合	gwao
餐厅	ixzx
女朋友	xkg
同情	ntyl
蜂蜜	cwac
所说的	zuu
心头	cxot
还将	mrqb
交叉	prxu
空中	avov
在身	ghps
发型	nfta
既有	kigk
进而	urti
专辑	wvyo
公社	mvdh
取决于	beh
食管	fsna
接口	jwok
打印	jxpp
景观	fxxu
为基础	emt
售价	yoii
骨干	yghg
个星期	ifm
变了	rxdj
不曾	mbkv
小于	vxhy
与你	syim
使之	ixgz
太有	dugk
便于	ixhy
制订	qnux
本书	gtdp
电视剧	fdr
郁闷	gknc
苏州	hssz
党风	zanf
仍有	ilgk
象征	exdt
可达	jkdr
一个个	tii
祝你	doim
转过	ywjr
这事	wrjo
就来	xvqk
广阔	rgnv
那么一	lct
相当于	geh
就行	xvdl
又来	xyqk
天堂	tdzh
着手	mmjs
又可	xyjk
取出	bxvc
都知道	eeq
可知	jkeo
什么也	icu
瞬息	mecm
外地	bihu
会很	iadk
之手	gzjs
绿化	sbil
还说	mruk
疲劳	fgxs
构建	gsbh
乐观	pvxu
不清楚	mvy
不应该	mru
加班	wjey
四年	zaev
你家	imaq
发扬	nfjl
注意到	vwt
这些人	wri
得意	dfwf
并对	qhxj
无意	hiwf
坏了	hmdj
总额	koaw
车上	ycit
我认为	jue
其中的	mou
疫苗	fohn
再度	enrh
家乡	aqsc
融资	tnef
发觉	nfzu
明白了	fud
查询	gfus
全年	sqev
出手	vcjs
贵州	cgsz
艺术家	hga
何以	ijby
联想	bkgm
就不能	xmv
之路	gzbw
遵守	qjaj
观看	xujm
组成部分	slwm
卫星	ptfc
女士	xnhs
心动	cxas
山东省	wym
不同程度	mnmr
他们是	iif
脱离	kkwz
更重要	xad
无明	hifk
深处	vawi
安置	yacy
摩托	ryjc
晚饭	fmmz
试图	ulzw
成交	lepr
不断提高	mkjx
平常	hkzb
视觉	duzu
牛肉	qnki
多个	bbiv
第九	nckj
世界各	unw
提起	jfre
马路	zmbw
同胞	ntks
船票	bndn
还想	mrgm
球队	ezpi
已经有	esg
艾滋	hxvq
偷偷	iaia
最早	fbfy
右手	gojs
发了	nfdj
那张	lpcy
用人	jyir
欺负	mfif
到时	thfj
我也是	juf
大批	ddjl
赋予	dtsx
乡村	scgj
延伸	crif
责任制	miq
目的是	muf
考虑到	eqt
晓得	fldf
经贸	sbpm
哈尔滨	omv
男朋友	nkg
不止	mbrz
老了	eldj
每月	eoky
手机	jsgn
下半	oxcb
但对	ifxj
新建	ndbh
丧失	yqes
独自	qccm
识别	uoka
伦理	iieh
帽子	bfiz
难题	xyfr
靠近	kbdr
艾滋病	hvf
隔离	ptwz
好冷	xiei
市场竞争	phwm
人民政府	ietr
形容	thaw
消灭	vetw
汉语	vxuc
英文	htww
五月	cwky
就开始	xtx
辉煌	eawu
莫名	imbo
有一定的	gtau
不觉	mbzu
早在	fygh
拓展	jtra
充实	paao
传感	iwlt
坏死	hmbl
一整	tygw
批判	jlca
西班牙	det
座谈会	rui
毛衣	qmpy
折磨	jdry
不相信	mgi
残疾	btfe
我以为	jbe
有意思	gwn
游泳	vtvu
近代	drmd
夫妇	yfxb
美容	mdaw
进出	urvc
现行	eudl
省委	mmmx
桌子	ifiz
公有	mvgk
是同	ftnt
罢了	chdj
想做	gmip
手工	jsvg
中外	ovbi
原发	zunf
促销	ible
很美	dkmd
布置	gbcy
修正	iwtr
停留	ixpm
总经理	kse
共和国	amz
致使	thix
这么说	wcu
大盘	ddbi
意识到	wut
想过	gmjr
开通	thsj
江苏省	vhm
也得	uydf
晚餐	fmix
海南	vexq
感激	ltvu
预后	sxko
师生	atcm
发起	nfre
产值	wciy
必将	ccqb
一枚	tygw
出售	vcyo
被告	pgkg
自行车	cdy
初期	pmmk
不能不	mvm
后期	komk
改为	ewes
角落	mjpw
退出	krvc
较小	ypvx
出于	vchy
势力	pssl
会长	iayc
无产	hiwc
肩膀	qkkw
舞蹈	ebbe
阿尔	pjmv
激活	vuva
水稻	zsme
暴力	fasl
换了	jmdj
引入	cvcu
震惊	zzyx
结构调整	sgug
老爷	elrp
版本	tzgt
这话	wrua
心底	cxrp
放大	twdd
灿烂	wwwq
询问	usno
纪检	sega
考生	evcm
利率	maps
据了解	jdm
机理	gneh
限度	pkrh
制成	qnle
中年	ovev
自杀	cmxg
法人	vhir
研究生	tac
制备	qnwn
分裂	mfba
路过	bwjr
听得	oddf
实时	aofj
法官	vhau
女装	xnqh
充满了	pvd
全局	sqre
鞋子	cbiz
本市	gtpb
次数	efkx
我发现	jne
绝望	smpk
停车	ixyc
挣扎	jmji
并未	qhqw
接收	jwyw
诞生	uccm
人身	irps
物品	qsoo
涂料	vvkk
领先	isqa
扶持	jyjh
口服	okkp
一万	tyte
给出	savc
年间	evnf
适用于	ajh
我们有	jig
作战	ikil
足以	bzby
澳大利亚	vdmo
火灾	whaw
空白	avub
教育部	epw
文本	wwgt
它们的	aiu
进攻	urvw
特异	qheh
党组织	zss
签名	nabo
流域	vphl
新加坡	nwh
行使	dlix
王子	ewiz
老是	elft
亮点	xnit
车子	yciz
占全	izsq
去买	hvdo
挺好	jsxi
年以来	ebq
取代	bxmd
存储	giiu
洪水	vazs
尴尬	iaii
水天	zstd
天生	tdcm
原子	zuiz
杀了	xgdj
想让	gmui
小型	vxta
自动化	cai
黑龙江	dgv
服务器	kwo
要回	dxzo
食用	fsjy
垄断	ghki
截至	yltv
停下	ixox
铸件	lkiq
摇头	jeot
待遇	dhnn
不看	mbjm
血浆	ciqb
会对	iaxj
江南	vvxq
正义	trux
惊讶	yxut
娃娃	xbxb
百年	tfev
天后	tdko
离婚	wzxp
长沙	ycvm
追究	urak
要让	dxui
与此同时	srnf
星星	fcfc
就更	xvxf
浑身	vaps
士兵	hsdm
身心	pscx
要对	dxxj
实习	aoex
心疼	cxfw
农户	bqqh
每周	eonh
缩小	savx
排名	jbbo
解除	mjpv
就必须	xcq
婚礼	xpdi
胃癌	nkfo
开门	thnm
友情	gxyl
淘汰	vsvd
选拔	qajn
反腐败	zrd
血流	civp
东京	yvxv
副主任	ppi
李鹏	gikk
美术	mdgu
一组	tysg
招待	jmdh
喜爱	kqeg
复习	efex
几句	njso
再一	enty
哪怕	olyu
一点也	tiu
血吸虫	coc
作出了	ivd
护士	jqhs
公益	mvqm
企业家	ioa
阴性	pkyc
农产	bqwc
能使	vkix
增殖	hkby
得知	dfeo
黄色	aemv
解放军	mta
制剂	qnwa
块钱	htlt
建立起	bwr
跟踪	bkba
主要有	pdg
离去	wzhv
赚钱	dqlt
以内	bykn
很开心	dtc
高度重视	xrad
是其	ftmq
也就是说	uxfu
但她	ifxu
间接	nfjw
正面	trtc
小编	vxsq
有人说	giu
下雪	oxzb
协助	ysgs
三角	csmj
在手	ghjs
语气	ucaq
遵循	qjdz
你给	imsa
主流	pzvp
验证	zaut
有这么	gwc
点点头	iio
扶贫	jymd
陪伴	pwic
农产品	bwo
出自	vccm
导向	ejuo
冷却	eihv
统计学	suz
光荣	etxg
早起	fyre
二者	weez
经营者	sxe
有心	gkcx
有的人	gui
有空	gkav
边界	srni
表现在	meg
充分利用	pmmj
大半	ddcb
情景	ylfx
一点点	tii
像个	ieiv
晚会	fmia
这份	wrim
椅子	gdiz
愈合	axao
手臂	jsrw
我不能	jmv
体制改革	iqec
从来没有	iqvg
有必要	gcd
发展中国家	nroa
六十	pmys
共享	amxi
一页	tyty
超声	rmrs
要来	dxqk
主要原因	pdzz
穿过	atjr
失业	esoy
概括	gkja
中介	ovia
率先	psqa
苦逼	hppr
清华	vlil
中山	ovws
搅拌	jzjc
又说	xyuk
大开	ddth
荣誉	xgzm
没关系	vkc
罗马	cbzm
何时	ijfj
家属	aqrc
几点	njit
饿了	mjdj
呼吁	ocoh
新技术	njg
南北	xqkl
无产阶级	hwps
大赛	ddau
月底	kyrp
嘴巴	olvb
告别	kgka
认为是	uef
时机	fjgn
流星	vpfc
外贸	bipm
就越	xvrl
黄河	aevj
协作	ysik
狗狗	qsqs
这几天	wnt
我擦	jlja
都应	eprz
外商	bins
吉林	kjyl
阿姨	pjxd
温州	vfsz
袭击	gphz
大厅	ddzx
带给	masa
没办法	vsv
传感器	ilo
界面	nitc
之事	gzjo
胡锦涛	plv
十大	ysdd
哎哟	ohos
都快	epyt
为之	esgz
既不	kimb
互动	toas
了无	djhi
学历	zizs
简称	nnmm
还需	mrzt
好美	ximd
再不	enmb
零售	ziyo
就应	xvrz
直播	ygjc
老年人	eei
总产	kowc
大爱	ddeg
男士	nshs
江泽民同志	vveh
大笑	ddnc
拼命	jqao
中出	ovvc
屁股	rlko
作为一个	ieti
遭遇	afnn
告诉他	kui
性别	ycka
民办	elsm
汇报	vjjp
土豆	htto
影响了	fod
街头	dbot
珍贵	eicg
圆满	zovh
一笔	tynq
济南	vwxq
检索	gaya
再看	enjm
器官	ooau
有待	gkdh
可以有	jbg
密码	actz
不做	mbip
地表	humq
犹豫	qisx
仅有	ixgk
民众	elii
重要作用	adij
幼儿园	saz
龙头	glot
客厅	awzx
平凡	hknu
较少	ypms
再去	enhv
提倡	jfif
预订	sxux
摇摇	jeje
勉强	maco
老太	eldu
要你	dxim
忙碌	yptb
见图	ujzw
祝贺	dowd
团队	zjpi
无情	hiyl
研讨会	tui
生产线	cws
伦敦	iixi
疗法	fdvh
压缩	zhsa
聚会	bxia
力学	slzi
接种	jwmo
太不	dumb
防范	ptpe
外交部	bpw
主编	pzsq
寒冷	auei
转让	ywui
从来不	iqm
都不知道	emeq
亲人	nqir
玩具	ejgm
设定	uoat
功率	vsps
会把	iajv
他认为	iue
少量	msft
饮料	mfkk
出色	vcmv
政权	trgx
来临	qkan
去哪	hvol
上半年	ice
提问	jfno
放疗	twfd
其实是	maf
被动	pgas
永恒	uzyt
高产	xgwc
找出	jlvc
你把	imjv
和尚	moes
直至	ygtv
好东西	xyd
第一天	ntt
要以	dxby
伴随	icpg
不当	mbeb
副主席	ppr
是把	ftjv
被你	pgim
不难	mbxy
业主	oypz
四大	zadd
爸妈	rvxz
传输	iwya
那时候	lfi
幽默	wsdd
物业	qsoy
对抗	xjjp
列车	bayc
家中	aqov
连忙	yryp
发生率	ncp
检疫	gafo
不重	mbah
许多人	ubi
随即	pgkp
破产	tgwc
这本	wrgt
自治区	cvj
而言	tiuy
其他的	miu
一定程度	tamr
有如	gkxo
签署	nace
过后	jrko
谁知	uyeo
过大	jrdd
列入	bacu
谁能	uyvk
节奏	hput
日记	frue
发动机	nag
中国特色	ozqm
中小企业	ovio
花了	hidj
赶到	rhth
关键是	klf
身体健康	piir
民营	elxo
了当	djeb
警告	hwkg
跑到	bsth
胖子	kciz
工作会议	viiu
廉政建设	rtbu
厘米	zhkm
响起	oure
物资	qsef
屋子	rtiz
车间	ycnf
太过	dujr
难怪	xyyx
外来	biqk
数十	kxys
前几	qxnj
几种	njmo
准则	eyda
整治	gwvv
一体化	tii
增产	hkwc
频道	rmqc
也许是	uuf
也看	uyjm
伊朗	ibuk
异性	ehyc
实际情况	apye
保佑	ioig
变革	rxcg
名单	bokf
前途	qxvr
设计师	uua
对付	xjij
水路	zsbw
搜索	juya
又一次	xte
快递	ytkc
这么大	wcd
带头	maot
管道	naqc
天上	tdit
美味	mdoq
他妈的	ixu
场面	hltc
悲哀	bcpo
总算	konm
中国政府	oztr
越大	rldd
叔叔	iviv
一瞬	tyme
一线	tyst
退休	krig
诗歌	uhjj
其中有	mog
大使	ddix
武功	tlvs
还不错	mml
心想	cxgm
行走	dlrz
为重	esah
如果是	xff
为例	esib
潜在	vygh
这人	wrir
无所谓	hzu
返回	zxzo
两名	zlbo
处处	wiwi
栽培	ylhw
这点	writ
思想政治工作	ngti
反馈	zxmc
决赛	etau
顺风耳	snb
同学们	nzi
生活在	cvg
污水	vwzs
化工	ilvg
球迷	ezkr
灯光	wxet
一两	tyzl
吃货	oeil
在内的	gku
调研	untt
既要	kidx
郑州	kdsz
小白	vxub
灵感	bwlt
不符	mbni
看电影	jff
全社会	sdi
这么好	wcx
竞赛	woau
金融机构	stgg
一同	tynt
党支部	zyw
终身	swps
抗生素	jcm
看不见	jmu
舍不得	amd
开设	thuo
还是有	mfg
解决问题	menf
日期	frmk
林业	yloy
经历了	szd
相继	gmsk
有道	gkqc
豆腐	tori
迟到	arth
不舒服	mak
下跌	oxbe
怎么回事	kczj
丝毫	ssxq
欺骗	mfzq
高档	xgge
下一个	oti
感慨	ltyk
高压	xgzh
将她	qbxu
不打	mbjx
吃过	oejr
排列	jbba
限量	pkft
传奇	iwdj
刑法	thvh
会说	iauk
当成	eble
放手	twjs
女友	xngx
波动	vgas
鲁迅	rfgy
不仅仅	mii
借助	iags
偶然	inbu
开会	thia
拉开	jwth
是怎样	fkg
构造	gskr
越是	rlft
小伙	vxiw
左手	gvjs
生死	cmbl
外汇	bivj
立足	wlbz
你觉得	izd
绝大多数	sdbk
商标	nsgn
大衣	ddpy
轿车	ycyc
小事	vxjo
会给	iasa
崩溃	wkvc
没吃	vooe
还应	mrrz
日下	frox
参赛	vdau
好累	xins
知识分子	eumi
窗外	aubi
高低	xgip
各部门	wwn
忍受	muex
腹部	kewo
鲜明	rmfk
精神文明建设	kdwu
关怀	kdym
什么人	ici
关闭	kdnj
个个	iviv
动员	asod
食堂	fszh
也是一种	uftm
密封	acbj
早日	fyfr
低温	ipvf
流泪	vpvm
侵犯	ibqe
变态	rxdu
纠纷	sysm
使命	ixao
年产	evwc
听取	odbx
花钱	hilt
邓小平理论	xvhu
标记	gnue
畜牧	snqw
排放	jbtw
采集	egyg
执着	pzmm
主意	pzwf
上皮	itgp
管理体制	neiq
发热	nfpt
东部	yvwo
控制系统	jqcs
本届	gtre
门诊	nmui
嘴里	olhl
好朋友	xkg
不发	mbnf
她又	xuxy
环境保护	ehij
辩证	wuut
含义	idux
金牌	sjtu
远处	jrwi
师傅	atij
蝴蝶	cpcu
层面	ratc
境内	hokn
服用	kpjy
看书	jmdp
半小时	cvf
大叔	ddiv
无敌	hiaw
定量	atft
视线	dust
大有	ddgk
一些人	tri
戏剧	xlrp
快快	ytyt
小儿	vxae
频繁	rmew
激光	vuet
浦东	vjyv
领导班子	ieei
想不到	gmt
决议	etuu
抢救	jjzu
任意	iswf
抽奖	jeqb
另外一	kbt
只手	omjs
管理部门	newn
举报	zmjp
也为	uyes
震撼	zzjl
童年	whev
氨基	aymh
繁殖	ewby
内科	knmk
坐着	iimm
宗旨	anlf
钥匙	lkfr
畸形	ndth
相爱	gmeg
未必	qwcc
乡镇企业	slio
良性	ukyc
淡定	vwat
不快	mbyt
水库	zsry
新产品	nwo
上市公司	ipme
心理学	cez
纪录	sebz
大片	ddtp
司马	etzm
立体	wlig
教研	eitt
揭示	jfns
吵架	omwg
视野	duhs
我需要	jzd
领导下	ieo
走路	rzbw
毒性	moyc
已经是	esf
想起了	grd
看好	jmxi
作文	ikww
低调	ipun
都还	epmr
遭受	afex
长远	ycjr
不公	mbmv
平板	hkgz
载体	ylig
准备好	ewx
多年来	beq
尸体	rsig
开辟	thro
更换	xfjm
也说	uyuk
另一种	ktm
支援	yxje
电梯	figk
衡量	dmft
动画	astn
广东省	rym
了些	djrl
属性	rcyc
干脆	hgkm
穿上	atit
主力	pzsl
很简单	dnk
救命	zuao
嘴唇	olzq
辈子	byiz
站起来	wrq
奥运会	uai
遥远	eqjr
迫切	urlm
也不要	umd
房价	qtii
说要	ukdx
也被	uypg
与之	sygz
社会经济	disv
担保	jfio
世界杯	ung
外语	biuc
把手	jvjs
客运	awar
凡是	nuft
有害	gkak
民事	eljo
模特	giqh
炎症	wwft
有权	gkgx
概率	gkps
享有	xigk
落在	pwgh
确诊	tmui
楼下	gkox
相遇	gmnn
码头	tzot
过敏	jreo
开关	thkd
不经	mbsb
但有	ifgk
香蕉	mfhy
引起了	crd
我爸	jlrv
都市	eppb
大海	ddve
除非	pvbf
我这个	jwi
一直是	tyf
沿着	vnmm
上进	itur
公子	mviz
巴勒斯坦	vcmh
每人	eoir
身影	psfv
羽绒	bysl
来不及	qml
认知	uieo
垂直	aayg
但其	ifmq
保温	iovf
腹腔	keka
极端	glww
街上	dbit
总书记	kdu
宽容	ahaw
被子	pgiz
虚拟	qojb
水晶	zsff
要死	dxbl
报警	jphw
城区	hljx
商店	nsri
宝贵	aecg
私营	mvxo
鉴别	anka
粘膜	kiki
拍卖	juyd
一旁	tywt
来吧	qkov
抽象	jeex
这边	wrsr
六个	pmiv
只有一个	ogti
没有一个	vgti
能把	vkjv
桌上	ifit
大肠	ddkl
三百	cstf
与会	syia
春秋	ufmw
不存在	mgg
定了	atdj
内蒙	knxw
没用	vojy
认可	uijk
策划	ngla
冷了	eidj
将他	qbiu
健康发展	irnr
怎么能	kcv
都不能	emv
情报	yljp
短暂	etyd
你所	imzr
二级	wesl
接下来	joq
随之	pggz
论证	uiut
借口	iaok
介入	iacu
商场	nshl
精确	kltm
河南省	vxm
做过	ipjr
事项	jovt
亚军	oyay
花生	hicm
十多	ysbb
挖掘	jajr
前期	qxmk
一轮	tyyi
抗原	jpzu
节省	hpmm
帅气	abaq
冷漠	eivi
一来	tyqk
八十	mbys
我们认为	jiue
实事求是	ajzf
冰箱	ezng
生病	cmft
看上去	jih
研究表明	tamf
同比	ntlb
浸润	vbvn
晚期	fmmk
无不	himb
好笑	xinc
人权	irgx
塑造	kkkr
切口	lmok
好似	xiib
邪恶	txoc
否认	moui
昆明	flfk
议会	uuia
陆续	phsy
最难	fbxy
相处	gmwi
问候	noir
请看	uljm
饭店	mzri
匆匆	sdsd
买到	doth
难忘	xypc
高清	xgvl
筛选	naqa
海峡	vewy
力气	slaq
变为	rxes
公有制	mgq
都不是	emf
适量	arft
假设	iruo
没说	vouk
液体	vpig
解剖	mjwo
这座	wrri
流程	vpmo
图形	zwth
会的	iaus
当下	ebox
仍在	ilgh
却没有	hvg
针织	lyso
红细胞	ssk
增值	hkiy
大街	dddb
不合理	mae
首先要	qqd
笑得	ncdf
本科	gtmk
几十年	nye
物价	qsii
不认识	muu
全会	sqia
外出	bivc
注视	vpdu
投标	jogn
死去	blhv
一幅	tybp
乖乖	akak
还未	mrqw
华丽	iltn
上前	itqx
而后	tiko
认同	uint
一间	tynf
合资	aoef
监督管理	aine
中美	ovmd
苍白	hjub
本报记者	gjue
以至	bytv
感兴趣	lzr
是这样的	fwgu
就走	xvrz
受到了	etd
大幅度	dbr
联邦	bkkp
不只	mbom
你就是	ixf
薄膜	pjki
阐述	nkgu
一个是	tif
又被	xypg
好象	xiex
言语	uyuc
草案	hfyg
低头	ipot
指定	jlat
灌注	vhvp
瞬时	mefj
外表	bimq
女神	xndf
地板	hugz
武林	tlyl
洗衣	vqpy
均可	hsjk
各大	wgdd
资助	efgs
又不是	xmf
减小	elvx
后天	kotd
模范	gipe
冷笑	einc
裤子	priz
血小板	cvg
离不开	wmt
好喜欢	xkx
图案	zwyg
二百	wetf
投诉	joud
不许	mbuq
听过	odjr
产业结构	wosg
影子	fviz
敢于	dbhy
强迫	cour
颁布	mtgb
副作用	pij
民警	elhw
起点	reit
学员	ziod
从今	iiid
约定	ssat
拍照	jufm
村里	gjhl
摩擦	ryja
完毕	ajly
功效	vspr
短短	etet
有才	gkjc
出国	vcze
入手	cujs
公寓	mvan
周一	nhty
心愿	cxzu
风雨	nfzy
国王	zeew
越多	rlbb
邮件	epiq
农业生产	bocw
航天	bptd
以免	bymo
无形	hith
有些事	grj
清洗	vlvq
隐藏	pmhl
省政府	mtr
养老	muel
膨胀	kkky
是吗	ftoz
语音	ucwf
习惯了	eyd
拿来	aoqk
最不	fbmb
口腔	okka
不在乎	mgc
行了	dldj
逛街	qedb
我等	jlnh
野生	hscm
嫁给	xasa
当然是	ebf
眼看	mkjm
身旁	pswt
溃疡	vcfl
该死	usbl
优越	iirl
其他人	mii
理智	eheo
伴有	icgk
运转	aryw
反弹	zxck
隧道	pqqc
女主	xnpz
感人	ltir
没法	vovh
用量	jyft
期限	mkpk
从没	iivo
速率	gops
供给	iasa
口袋	okmp
性状	ycqd
储备	iuwn
线性	styc
配备	dewn
几百	njtf
有理	gkeh
会想	iagm
季度	mirh
用品	jyoo
判决	caet
一处	tywi
姿势	efps
针对性	lxy
技术人员	jgio
邓小平同志	xvhh
口中	okov
它在	algh
薄弱	pjce
微薄	fnpj
有序	gkrs
前提下	qjo
话费	uaca
创办	jasm
还以为	mbe
说起	ukre
阴阳	pkpf
被打	pgjx
不以	mbby
柔软	sxyf
可谓	jkun
高潮	xgvy
是多么	fbc
不堪	mbhm
惊人	yxir
我用	jljy
附加	piwj
抛弃	jkph
称号	mmov
精致	klth
上讲	ituu
间隙	nfpv
弥补	cmpi
行情	dlyl
带回	mazo
看清	jmvl
开发区	tnj
而他	tiiu
举措	zmja
国民党	zez
一度	tyrh
股骨	koyg
平稳	hkmm
协商	ysns
法定	vhat
颤抖	ptjk
用电	jyfi
就是一个	xfti
天才	tdjc
抵达	jpdr
即便	kpix
台北	vokl
可靠性	jky
滋味	vqoq
初级	pmsl
关联	kdbk
整整	gwgw
棉花	guhi
逃避	eerw
当局	ebre
传说中	iuo
套装	ddqh
这回	wrzo
可有	jkgk
呕吐	ojoh
那些年	lre
知识产权	euwg
买卖	doyd
大好	ddxi
不尽	mbae
满了	vhdj
尊严	qjoc
在京	ghxv
拿了	aodj
佩服	inkp
老实	elao
外界	bini
结束后	sgk
数码	kxtz
信息技术	icjg
将成	qble
国情	zeyl
来回	qkzo
和服	mokp
曝光	ffet
条路	wgbw
笑话	ncua
心目	cxmm
起码	retz
和美	momd
在这儿	gwa
国际市场	zpph
名人	boir
却在	hvgh
恶性肿瘤	oykf
应用于	rjh
一听	tyod
第一名	ntb
若不	hgmb
置于	cyhy
很长	dkyc
党风廉政	znrt
不远	mbjr
开创	thja
现已	euey
地带	huma
获奖	hqqb
规范化	ypi
公务员	mwo
一早	tyfy
生育	cmpk
漫画	vftn
人品	iroo
院长	payc
百万	tfte
痕迹	fkrr
密集	acyg
我曾	jlkv
登录	btbz
不稳定	mma
发电	nffi
什么东西	icyd
建筑物	bnq
周五	nhcw
还有一个	mgti
甲状腺	nqk
奠定	qdat
百分点	tmi
这种事	wmj
负荷	ifhi
省级	mmsl
牛逼	qnpr
主持人	pji
究竟是	aof
做梦	ipyb
多少人	bmi
经营管理	sxne
偶像	inie
沥青	vzlq
应付	rzij
平淡	hkvw
电源	fivz
失误	esuo
翻了	cndj
电机	fign
保守	ioaj
阻力	pgsl
电池	fivu
副书记	pdu
折腾	jdkn
北大	kldd
楼梯	gkgk
妊娠	xsxz
国有资产	zgew
纺织	stso
开工	thvg
崇拜	wajt
变换	rxjm
试剂	ulwa
但它	ifal
板块	gzht
到最后	tfk
嫌疑	xqle
动机	asgn
美国人	mzi
大局	ddre
芯片	hctp
宁愿	anzu
船舶	bnbu
十足	ysbz
根本就	ggx
微风	fnnf
场地	hlhu
低声	iprs
肝癌	khfo
题材	frgj
转化为	yie
社会科学	dimz
共识	amuo
发展到	nrt
话语	uauc
夜里	pihl
生物学	cqz
董事长	hjy
当场	ebhl
校车	gpyc
此后	rlko
弟子	kciz
企图	irzw
地处	huwi
领袖	ispe
一大早	tdf
分工	mfvg
收回	ywzo
笔记本	nug
心目中	cmo
地域	huhl
范畴	penk
通报	sjjp
和解	momj
连锁	yrle
劳动者	xae
动人	asir
午餐	qwix
大道	ddqc
大发	ddnf
根本上	ggi
矿产	trwc
这个时候	wifi
乘客	mkaw
等国	nhze
可分	jkmf
还很	mrdk
大方	ddtf
别说	kauk
生命中	cao
十六大	ypd
外观	bixu
荷兰	hiqw
军人	ayir
一举	tyzm
君子	bciz
镜子	loiz
关系到	kct
人民医院	iejp
双重	xxah
这时候	wfi
道歉	qcqr
快去	ythv
卵巢	pesf
跨年	bdev
消极	vegl
好开心	xtc
严厉	oczt
反射	zxpj
佛教	icei
如果没有	xfvg
想得	gmdf
副部	pawo
发病率	nfp
乐趣	pvrb
严峻	ocwv
市场经济体制	phsq
突变	adrx
开启	thqo
债权	imgx
是这个	fwi
公告	mvkg
留给	pmsa
吃得	oedf
同一个	nti
别墅	kahs
大夫	ddyf
骨髓	ygyg
规格	yugw
古典	pgna
深层	vara
电动	fias
喜悦	kqyk
参照	vdfm
迷人	krir
胃肠	nkkl
自尊	cmqj
有条	gkwg
占据	izjr
包包	sbsb
不妨	mbxt
丢了	atdj
演讲	vauu
千年	aqev
有效率	gpp
客气	awaq
牙齿	txri
你敢	imdb
狠狠	qkqk
仪表	iumq
中日	ovfr
变量	rxft
立方	wltf
一带	tyma
师父	atrf
特大	qhdd
多吃	bboe
举手	zmjs
古老	pgel
路面	bwtc
打扮	jxjm
中期	ovmk
柠檬	gagx
称之	mmgz
又开始	xtx
深夜	vapi
七十	lqys
为这	eswr
萝卜	hcib
只为	omes
裁判	ylca
战场	ilhl
牛仔	qnii
沉积	vamo
可能有	jvg
例子	ibiz
死亡率	bpp
珍珠	eieq
处分	wimf
大桥	ddgc
据统计	jsu
纯粹	slkp
大国	ddze
说说	ukuk
点多	itbb
生产经营	cwsx
不分	mbmf
写出	asvc
集中在	yog
上天	ittd
十七	yslq
今天下午	itoq
衬衫	pjpq
这是什么	wfic
抗日	jpfr
已经在	esg
一心	tycx
内蒙古	kxp
曾在	kvgh
零件	ziiq
老天	eltd
光芒	ethp
海上	veit
矮油	emve
心得	cxdf
新娘	ndxu
新形势	ntp
这与	wrsy
贯彻落实	odpa
针灸	lymu
都得	epdf
来找	qkjl
想哭	gmoo
被窝	pgao
还原	mrzu
安心	yacx
切片	lmtp
大年	ddev
例外	ibbi
口水	okzs
围巾	zwbj
你以为	ibe
多媒体	bxi
博物	yjqs
太好了	dxd
去过	hvjr
对立	xjwl
富裕	appw
总裁	koyl
罚款	cuhn
片刻	tpsa
副部长	pwy
惩罚	dtcu
却有	hvgk
讲究	uuak
心思	cxnc
以为是	bef
散发	aknf
草原	hfzu
放过	twjr
应有的	rgu
安定	yaat
主权	pzgx
热量	ptft
应在	rzgh
美军	mday
也已	uyey
三级	cssl
甘肃	htbm
轻度	ybrh
序列	rsba
法治	vhvv
这才是	wjf
想出	gmvc
年终	evsw
有一点	gti
描写	jhas
共产党员	awzo
符号	niov
懂了	yhdj
不时	mbfj
桥梁	gcvm
给药	sahs
我愿	jlzu
天啊	tdop
不管是	mnf
万物	teqs
中学生	ozc
全国人民	szie
发展战略	nrin
往往是	ddf
队长	piyc
多发	bbnf
两点	zlit
名义	boux
偏偏	iqiq
发言人	nui
压迫	zhur
困境	zgho
一门	tynm
老鼠	elub
调查研究	ugta
风云	nfay
极限	glpk
以致	byth
诱发	umnf
病灶	ftwh
修养	iwmu
康复	rbef
播放	jctw
十分重要	ymad
华人	ilir
怀里	ymhl
此事	rljo
补贴	pidi
而出	tivc
规章	yuoz
是那么	flc
希腊	xgka
审议	afuu
多谢	bbup
脉冲	kueo
就连	xvyr
后一	koty
好不容易	xmaf
照射	fmpj
减少了	emd
评定	uhat
柬埔寨	gha
念头	idot
必须要	cqd
面貌	tcqu
大战	ddil
打工	jxvg
授权	jegx
环境中	eho
深情	vayl
魔法	ryvh
制止	qnrz
烟草	wzhf
了解到	dmt
心血管	ccn
忘记了	pud
回国	zoze
假期	irmk
很可能	djv
他知道	ieq
无需	hizt
淘宝网	van
乳腺癌	ekf
造成了	kld
面膜	tcki
总觉	kozu
所用	zrjy
中断	ovki
实话	aoua
可以看到	jbjt
奖金	qbsj
这两天	wzt
为啥	esoa
在场	ghhl
长久	ycmu
怀孕	ymli
大叫	ddoy
心痛	cxfs
支配	yxde
转给	ywsa
养成	mule
亮了	xndj
可以使	jbi
焦虑	yjqc
尽情	aeyl
有一次	gte
各级领导	wsie
心跳	cxbe
技术创新	jgjn
新人	ndir
大致	ddth
凤凰	nxnu
可得	jkdf
欧元	jxjy
一秒	tymm
责任感	mil
谨慎	uhyy
本事	gtjo
麻将	ryqb
幸好	hqxi
搞得	jxdf
两个月	zik
改良	ewuk
不带	mbma
残酷	btdk
并以	qhby
远程	jrmo
阴影	pkfv
莫名其妙	ibmx
好感	xilt
仿真	ityg
孕妇	lixb
闭上	njit
唯有	oygk
一月	tyky
越好	rlxi
老夫	elyf
都将	epqb
区分	jxmf
书法	dpvh
另有	klgk
鉴于	anhy
控制器	jqo
还有什么	mgic
永远是	ujf
出租车	vmy
毛泽东思想	qvyg
先行	qadl
育种	pkmo
设想	uogm
礼品	dioo
又如	xyxo
线索	stya
势头	psot
前两	qxzl
诸如	uexo
科学研究	mzta
即使是	kif
学期	zimk
车站	ycwi
小城	vxhl
优美	iimd
学报	zijp
遗忘	crpc
变异	rxeh
数值	kxiy
就此	xvrl
干了	hgdj
分成	mfle
我们将	jiq
最快	fbyt
携带	jyma
泉州	uzsz
计量	uyft
夏季	tmmi
胆囊	kfyo
联络	bksw
降临	pwan
授予	jesx
专柜	wvgj
形势下	tpo
推开	jyth
才可	jcjk
电磁	fitq
验收	zayw
永不	uzmb
而无	tihi
完全是	asf
旗帜	tmbo
场合	hlao
金刚	sjnx
下车	oxyc
有谁	gkuy
不值	mbiy
媳妇	xcxb
往事	dpjo
真爱	ygeg
钻井	liuj
全区	sqjx
果然是	fbf
看待	jmdh
延续	crsy
机床	gnrg
大爷	ddrp
不便	mbix
模仿	giit
煤炭	whwg
较差	ypmv
钢铁	lnle
一点也不	tium
每一次	ete
便可	ixjk
亲密	nqac
埃及	hvlj
工程师	vma
指着	jlmm
倡导	ifej
孔子	iiiz
一瞬间	tmn
指甲	jlnj
电子商务	finw
门外	nmbi
必定	ccat
厂商	zcns
华盛顿	ill
叙述	vxgu
年会	evia
阻碍	pgtf
简化	nnil
钱包	ltsb
拉着	jwmm
全党	sqza
处方	witf
我们家	jia
散文	akww
开发商	tnn
商量	nsft
获悉	hqck
饮水	mfzs
穿刺	atgn
不利于	mmh
清晨	vlfz
卧室	jvat
遗产	crwc
诚信	uliu
纳税	skmk
之心	gzcx
体温	igvf
扮演	jmva
同类	ntkd
结核	skgs
支架	yxwg
自私	cmmv
焦点	yjit
有时间	gfn
这天	wrtd
跑了	bsdj
多层	bbra
所作	zrik
更要	xfdx
活得	vadf
体力	igsl
去死	hvbl
没能	vovk
这样说	wgu
共产主义	awpu
特有	qhgk
生活方式	cvtl
酒吧	vdov
欧阳	jxpf
导管	ejna
窗户	auqh
行驶	dlzo
在这样	gwg
舍得	apdf
凝固	eszp
一圈	tyzn
师兄	atoa
起步	rerm
肥胖	kvkc
直线	ygst
从根本上	iggi
申报	fvjp
安全感	ysl
姿态	efdu
溶解	vamj
甜美	ahmd
净化	emil
三星	csfc
计数	uykx
残疾人	bfi
有名	gkbo
遇上	nnit
我们必须	jicq
大楼	ddgk
肝脏	khkr
成年	leev
就已经	xes
提交	jfpr
喉咙	orog
播种	jcmo
中东	ovyv
手下	jsox
复古	efpg
祈祷	dddk
猪肉	qeki
市区	pbjx
重重	ahah
县委	gvmx
多方面	btt
泡沫	vsvq
好难	xixy
必备	ccwn
能给	vksa
往前	dpqx
为首	esqc
十月	ysky
一律	tydb
墙上	hyit
最长	fbyc
有问题	gnf
年代初	emp
如果说	xfu
中方	ovtf
树脂	gxkl
这样就	wgx
不失	mbes
小孩子	vii
走私	rzmv
什么意思	icwn
去世	hvus
紫外	rlbi
着急	mmmb
分辨	mfwy
不通	mbsj
灰色	gwmv
上传	itiw
历程	zsmo
看作	jmik
首先是	qqf
变动	rxas
睡前	maqx
通行	sjdl
新华社记者	nide
每当	eoeb
法庭	vhrs
开玩笑	ten
福州市	dsp
应是	rzft
两手	zljs
犹如	qixo
引人	cvir
长期以来	ymbq
充足	pabz
班子	eyiz
称之为	mge
怎能	kcvk
服从	kpii
先天	qatd
博物馆	yqm
秒杀	mmxg
总觉得	kzd
最后一个	fkti
克隆	papw
快要	ytdx
冠状	ajqd
支气管	yan
纪委	semx
走下	rzox
报刊	jpha
问卷	none
有何	gkij
脊髓	kayg
宁静	anlm
党风廉政建设	znru
肯定是	raf
几何	njij
家门	aqnm
收到了	ytd
工业化	voi
不爽	mbdx
占领	izis
每一天	ett
弄得	ehdf
体检	igga
来讲	qkuu
幼稚	ssmy
持有	jhgk
丫头	kvot
所能	zrvk
到这里	twh
力争	slmb
左边	gvsr
没钱	volt
进取	urbx
年里	evhl
约会	ssia
放到	twth
相差	gmmv
海军	veay
草莓	hfhe
闪闪	nini
陪同	pwnt
这在	wrgh
此类	rlkd
中长	ovyc
创伤	jaie
赠送	dkkd
良心	ukcx
病程	ftmo
一再	tyen
保卫	iopt
如果他	xfi
自然科学	cbmz
笔者认为	neue
地图	huzw
他将	iuqb
供水	iazs
样本	gmgt
仅仅是	iif
不见了	mud
残留	btpm
过高	jrxg
只剩下	omo
理论上	eui
出声	vcrs
复制	efqn
告诉我们	kuji
视力	dusl
之道	gzqc
王国	ewze
夸张	dwcy
哪有	olgk
也是我	ufj
启发	qonf
下去了	ohd
听听	odod
冒险	fmpa
浮云	veay
少见	msuj
茶叶	hioy
新时期	nfm
邻居	isrp
日本人	fgi
几个月	nik
观测	xuvd
剩余	mkvy
跳舞	beeb
莫斯科	imm
就到	xvth
招商	jmns
分明	mffk
误诊	uoui
痊愈	fsax
要为	dxes
仅为	ixes
持久	jhmu
姓名	xcbo
占地	izhu
想像	gmie
说得也是	uduf
为实	esao
级别	slka
没听	vood
陪着	pwmm
杀死	xgbl
均衡	hsdm
哥们	jjin
最可	fbjk
综合征	sad
更快	xfyt
跨国	bdze
假装	irqh
奢侈	deib
难免	xymo
只在	omgh
北部	klwo
必须有	cqg
大力发展	dsnr
酸奶	dvxl
好评	xiuh
见了	ujdj
恶化	ocil
五百	cwtf
过滤	jrvq
便利	ixma
信誉	iuzm
破裂	tgba
残忍	btmu
神色	dfmv
面子	tciz
摇摇头	jjo
回到家	zta
新兴	ndzm
兔子	utiz
社会上	dii
时有	fjgk
头晕	otfa
三千	csaq
进化	uril
杀手	xgjs
经济社会	svdi
对外开放	xbtt
场景	hlfx
保养	iomu
布什	gbiy
表彰	mqoq
走势	rzps
抗议	jpuu
旨在	lfgh
爱着	egmm
无穷	hias
副总理	pke
人参	irvd
批发	jlnf
刚好	nxxi
跟她	bkxu
支柱	yxgp
钢琴	lnee
安全性	ysy
结果是	sff
交谈	pruw
山水	wszs
全国政协	szty
风情	nfyl
条约	wgss
水电	zsfi
万人	teir
求解	zumj
何况	ijeo
制度改革	qrec
长袖	ycpe
不符合	mna
转动	ywas
降水	pwzs
研发	ttnf
号召	ovmz
活在	vagh
不合格	mag
笑声	ncrs
多元化	bji
挫折	jijd
特异性	qey
噪声	oors
不停地	mih
书籍	dpnq
依照	ipfm
他用	iujy
讲述	uugu
三月	csky
相适应	gar
修订	iwux
引流	cvvp
受益	exqm
小学生	vzc
聚合	bxao
我靠	jlkb
不完全	mas
脚下	khox
中国联通	ozbs
试用	uljy
压抑	zhjp
综合性	say
援助之手	jggj
透过	mljr
萎缩	hmsa
亲戚	nqli
要比	dxlb
录取	bzbx
看见了	jud
顾问	zeno
打死	jxbl
座位	riiw
微生物	fcq
优于	iihy
中原	ovzu
跨越	bdrl
社会主义现代化	dipi
下列	oxba
瑞士	ewhs
腐蚀	rimc
已经成为	esle
南部	xqwo
拓宽	jtah
秘书长	mdy
断裂	kiba
阴道	pkqc
但愿	ifzu
有生	gkcm
题目	frmm
讲座	uuri
辣椒	wggi
贵族	cgte
失落	espw
检出	gavc
漫长	vfyc
上门	itnm
包容	sbaw
新品	ndoo
一贯	tyod
秒钟	mmlo
叫道	oyqc
少数民族	mket
之间的关系	gnuc
华侨	ilic
沉淀	vava
走吧	rzov
底下	rpox
并有	qhgk
饺子	mpiz
没睡	voma
显示出	fnv
行李	dlgi
当然不	ebm
光辉	etea
几位	njiw
社会化	dii
一如	tyxo
不知不觉	memz
还给	mrsa
机器人	goi
行政管理	dtne
鼓舞	kqeb
小雨	vxzy
全方位	sti
淀粉	vakm
传染病	ivf
别再	kaen
振兴	jzzm
全面发展	stnr
而且是	tgf
膀胱	kwke
一次性	tey
谁是	uyft
无声	hirs
大自然	dcb
放了	twdj
贪污	idvw
这都	wrep
股权	kogx
但仍	ifil
鄙视	ozdu
慢慢地	yyh
带上	mait
四处	zawi
影像	fvie
背影	klfv
阿拉伯	pji
酒精	vdkl
老人家	eia
陌生人	pci
工会	vgia
口号	okov
不再是	mef
爱吃	egoe
着力	mmsl
宽带	ahma
入院	cupa
打底	jxrp
事先	joqa
这首歌	wqj
画家	tnaq
社会保障	diip
德育	dypk
羊毛	myqm
季军	miay
心电	cxfi
时常	fjzb
争论	mbui
志愿者	hze
杭州市	gsp
家居	aqrp
前列腺	qbk
疲惫	fgwn
美学	mdzi
只得	omdf
仍不	ilmb
头像	otie
谁来	uyqk
落下	pwox
赶上	rhit
好像是	xif
列为	baes
糟糕	kakm
烦躁	wtbo
将对	qbxj
摆在	jcgh
明知	fkeo
精美	klmd
都比	eplb
本周	gtnh
倾斜	ilvk
荧光	xwet
不小心	mvc
人际	irpn
衰老	poel
年版	evtz
宏观调控	axuj
不确定	mta
大眼	ddmk
要买	dxdo
庞大	rgdd
哭泣	oovw
学位	ziiw
回应	zorz
自有	cmgk
前方	qxtf
隔壁	ptrw
但从	ifii
流失	vpes
本月	gtky
桌面	iftc
硕士	tths
机动	gnas
软骨	yfyg
反思	zxnc
潇洒	vhvd
那句	lpso
期刊	mkha
一封	tybj
并与	qhsy
非常重要	bzad
争夺	mbdj
分级	mfsl
局势	reps
加剧	wjrp
管理人员	neio
晚了	fmdj
红了	svdj
想起来	grq
灾难	awxy
迄今	egid
常务	zbws
自豪	cmxq
只不过是	omjf
较长	ypyc
婆婆	vgvg
月后	kyko
好啦	xioj
并无	qhhi
让它	uial
大腿	ddkk
指责	jlmd
人大常委	idzm
我想你	jgi
来个	qkiv
看成	jmle
壮大	qhdd
致力	thsl
致富	thap
格外	gwbi
站着	wimm
白细胞	usk
相连	gmyr
原材料	zgk
皇上	ueit
一幕	tyib
叹息	oxcm
片子	tpiz
西瓜	dxrg
加之	wjgz
少爷	msrp
带走	marz
再一次	ete
不仅要	mid
个地方	iht
癌症	foft
面孔	tcii
时间里	fnh
有意义	gwu
平滑	hkvy
约翰	ssyy
洗净	vqem
到手	thjs
终究	swak
极了	gldj
资产阶级	ewps
地狱	huqd
一晚	tyfm
这一次	wte
神圣	dfxh
在那儿	gla
误会	uoia
吉祥	kjdm
羽绒服	bsk
高尚	xges
傻瓜	iurg
恶劣	ocms
脑海	kwve
绘画	sitn
仍然是	ibf
落到	pwth
喝水	ofzs
编写	sqas
又一个	xti
基督	mhix
面部	tcwo
钻石	lits
辅导	yjej
头一	otty
时空	fjav
还不是	mmf
养生	mucm
人民法院	ievp
分数	mfkx
长安	ycya
入口	cuok
吓得	oodf
三点	csit
合作关系	aikc
弯曲	rcfa
先锋	qalw
张力	cysl
从业	iioy
一所	tyzr
长春	ycuf
国土	zeht
条款	wghn
赢取	pdbx
景象	fxex
细致	snth
那条	lpwg
万一	tety
数百	kxtf
放置	twcy
必需	cczt
库区	ryjx
人大常委会	idzi
美帝	mdwb
墨西哥	ddj
水面	zstc
有几个	gni
清水	vlzs
磷酸	tkdv
是有多	fgb
标准化	gei
童话	whua
它就	alxv
不就是	mxf
份额	imaw
下肢	oxky
出入	vccu
找了	jldj
迎来	ppqk
两三	zlcs
什么叫	ico
只看	omjm
一期	tymk
忧伤	yiie
伤感	ielt
比较好	lyx
演绎	vasx
教导	eiej
束缚	gosj
加深	wjva
月中	kyov
长长	ycyc
公顷	mvlt
国会	zeia
寝室	aqat
慰问	rjno
格式	gwlv
困扰	zgji
也曾	uykv
胡萝卜	phi
体质	igzy
拯救	jdzu
会好	iaxi
精华	klil
被称为	pme
防护	ptjq
冬装	weqh
国际上	zpi
这下	wrox
上游	itvt
都给	epsa
吃到	oeth
黑白	dhub
案例	ygib
被迫	pgur
两件	zliq
屋里	rthl
玩意	ejwf
节点	hpit
多月	bbky
最后一天	fktt
又会	xyia
这一天	wtt
日趋	frrm
杯子	gmiz
毛病	qmft
张图	cyzw
演变	varx
想找	gmjl
为本	esgt
房产	qtwc
抱歉	jsqr
既可	kijk
也可能	ujv
只听	omod
内有	kngk
纳米	skkm
冰冷	ezei
计较	uyyp
病因	ftzd
长达	ycdr
牌子	tuiz
起着	remm
来信	qkiu
统筹	spnk
加厚	wjzf
师范	atpe
粉碎	kmtp
首要	qcdx
一无	tyhi
挂在	jbgh
经济体	svi
审核	afgs
打得	jxdf
党内	zakn
红星	svfc
任何一个	iiti
办案	smyg
稀释	mxck
很爱	dkeg
尽力	aesl
未经	qwsb
民主党	epz
上车	ityc
盈利	lxma
心爱	cxeg
劳力	xssl
打的	jxus
新中国	noz
三位	csiw
警惕	hwyf
高大	xgdd
印刷	pprb
之情	gzyl
我们会	jii
储蓄	iuhs
体现在	ieg
婚纱	xpsm
人力资源	isev
进出口	uvo
接过	jwjr
嘴角	olmj
水土	zsht
韩寒	yyau
同志们	nhi
依托	ipjc
四川省	zsm
比起	lbre
阳台	pfvo
作为一种	ietm
则可	dajk
金币	sjcb
今儿	idae
约为	sses
冲洗	eovq
神龙	dfgl
防火	ptwh
不定	mbat
体征	igdt
即是	kpft
洛阳	vwpf
叶片	oytp
恰恰	yaya
核算	gsnm
礼拜	dijt
更深	xfva
大豆	ddto
较快	ypyt
妥善	exmq
在用	ghjy
走来	rzqk
命名	aobo
百度	tfrh
企业管理	ione
往来	dpqk
排出	jbvc
掀起	jdre
理事	ehjo
往下	dpox
有关规定	gkya
沙漠	vmvi
深受	vaex
关键词	klu
北约	klss
廉洁	rqvk
融入	tncu
尚不	esmb
蔓延	hfcr
但又	ifxy
气势	aqps
极度	glrh
永远不会	ujmi
倾听	ilod
农药	bqhs
不具	mbgm
抵押	jpjn
进度	urrh
自制	cmqn
失常	eszb
气管	aqna
教研室	eta
点解	itmj
合法权益	avgq
一时间	tfn
中意	ovwf
是一件	fti
很高兴	dxz
其所	mqzr
可笑	jknc
示意	nswf
里去	hlhv
是让	ftui
麻麻	ryry
集合	ygao
多小	bbvx
通风	sjnf
药理	hseh
摩托车	rjy
影响到	fot
当选	ebqa
店铺	rilj
液压	vpzh
没见过	vuj
这些问题	wrnf
建国	bhze
香水	mfzs
是多少	fbm
西部大开发	dwdn
出院	vcpa
学说	ziuk
滞后	vmko
不被	mbpg
开花	thhi
不是说	mfu
中大	ovdd
重要组成部分	adsm
冬至	wetv
兴起	zmre
多见	bbuj
又出	xyvc
不进	mbur
一团	tyzj
神话	dfua
向往	uodp
逐年	qrev
什么地方	icht
不可思议	mjnu
也算	uynm
世间	usnf
她要	xudx
纯洁	slvk
建立在	bwg
无能	hivk
解放思想	mtng
氨基酸	amd
没来	voqk
不能说	mvu
过身	jrps
最强	fbco
封信	bjiu
干涉	hgvr
天涯	tdvz
指导思想	jeng
冠状动脉	aqak
最深	fbva
可以说是	jbuf
叫人	oyir
无论如何	huxi
能说	vkuk
祝愿	dozu
复位	efiw
计划经济	ulsv
麻痹	ryfn
上演	itva
厂长	zcyc
整齐	gwwa
不一样的	mtgu
生机	cmgn
写着	asmm
礼貌	diqu
成品	leoo
生产能力	cwvs
日后	frko
生化	cmil
懒得	ygdf
议论	uuui
五分	cwmf
途中	vrov
注意力	vws
岂不	wemb
长城	ychl
为期	esmk
崇高	waxg
各界	wgni
也难	uyxy
外长	biyc
大便	ddix
瞪着	mbmm
游离	vtwz
有成	gkle
有价	gkii
小女孩	vxi
法轮	vhyi
不超过	mrj
传说中的	iuou
艰巨	xkjr
胸部	kswo
适时	arfj
小伙子	vii
影视	fvdu
身份证	piu
微波	fnvg
商城	nshl
工地	vghu
地步	hurm
很多事	dbj
就一定	xta
这辈子	wbi
海关	vekd
吃饱	oems
法学	vhzi
收了	ywdj
知足	eobz
贫血	mdci
绝对是	sxf
无疑是	hlf
位移	iwmb
乐园	pvzj
凝视	esdu
不听	mbod
冠心病	acf
宾馆	adma
不仅仅是	miif
省市	mmpb
帝国主义	wzpu
羽毛	byqm
有道理	gqe
征收	dtyw
感叹	ltox
亚太	oydu
饮用	mfjy
之时	gzfj
弘扬	cvjl
中指	ovjl
回过	zojr
整个人	gii
战术	ilgu
心律	cxdb
商家	nsaq
重要意义	adwu
错的	laus
稍微	mefn
质疑	zyle
再用	enjy
门前	nmqx
磨损	ryjo
隆重	pwah
十二月	ywk
菊花	hshi
科教	mkei
几个人	nii
最想	fbgm
长了	ycdj
呼唤	ocom
以防	bypt
精灵	klbw
吸引力	ocs
捐款	john
如果我们	xfji
间隔	nfpt
介质	iazy
风光	nfet
打扰	jxji
大礼	dddi
新春	nduf
自在	cmgh
落地	pwhu
深厚	vazf
一号	tyov
月经	kysb
报复	jpef
就叫	xvoy
说来	ukqk
祝大家	dda
罕见	ahuj
我想起	jgr
受害	exak
中部	ovwo
四月	zaky
也知道	ueq
不下去	moh
正因	trzd
改制	ewqn
态势	dups
物体	qsig
密切相关	algk
投产	jowc
减弱	elce
温和	vfmo
倒在	itgh
千万不要	atmd
宽松	ahgm
还需要	mzd
国家和地区	zamj
抬起头	jro
我国经济	jzsv
永久	uzmu
知识经济	eusv
颈椎	bvgy
呈现出	oev
满脸	vhka
裂缝	basw
不适合	maa
热线	ptst
行人	dlir
写下	asox
消失了	ved
原先	zuqa
存活	giva
不干	mbhg
感性	ltyc
不甘	mbht
也未	uyqw
输送	yakd
谁说	uyuk
右侧	goid
各级政府	wstr
大厦	ddzt
流浪	vpvu
梦中	ybov
恋人	rcir
就是说	xfu
时时	fjfj
后才	kojc
就应该	xru
爱过	egjr
千里	aqhl
交警	prhw
苦笑	hpnc
段时间	dfn
占用	izjy
但如	ifxo
并提	qhjf
回了	zodj
流水	vpzs
周六	nhpm
由此可见	erju
生活水平	cvzh
四季	zami
越高	rlxg
润滑	vnvy
四肢	zaky
来电	qkfi
太子	duiz
年时	evfj
一碗	tyta
赞成	qqle
交代	prmd
修建	iwbh
河北省	vkm
谎言	uhuy
上方	ittf
是这么	fwc
皮质	gpzy
太高	duxg
温泉	vfuz
保湿	iovf
只是一个	ofti
收取	ywbx
南宫	xqao
面上	tcit
编码	sqtz
简便	nnix
标志着	ghm
初始	pmxv
疫情	foyl
看电视	jfd
倒霉	itze
长款	ychn
个股	ivko
徽章	fsoz
对称	xjmm
扎实	jiao
何处	ijwi
编号	sqov
我们看	jij
集装箱	yqn
崛起	wrre
歌手	jjjs
源头	vzot
上个	itiv
破碎	tgtp
违规	wpyu
得分	dfmf
三个月	cik
几千	njaq
十个	ysiv
爱国主义	ezpu
首相	qcgm
外婆	bivg
赞同	qqnt
自发	cmnf
地主	hupz
所属	zrrc
成为一个	leti
如有	xogk
梦见	ybuj
湖北省	vkm
做起	ipre
审理	afeh
界限	nipk
家电	aqfi
处置	wicy
天文	tdww
方才	tfjc
世界观	unx
人死	irbl
就如	xvxo
骗子	zqiz
涉及到	vlt
宫颈	aobv
交际	prpn
受了	exdj
秋天	mwtd
他们说	iiu
后发	konf
党员干部	zohw
面临着	tam
不同于	mnh
一大批	tdj
易于	fshy
战线	ilst
归纳	absk
送来	kdqk
尊敬	qjho
紧迫	axur
有情	gkyl
左侧	gvid
儿女	aexn
妈咪	xzok
造就	krxv
尤为	iues
火焰	whwm
麻木	rygm
一说	tyuk
来访	qkut
腰椎	kdgy
这种人	wmi
抽样	jegm
智商	eons
滚滚	vpvp
尺度	acrh
睡意	mawf
通讯员	suo
分组	mfsg
导弹	ejck
任性	isyc
紊乱	wsai
立方米	wtk
台阶	vopi
高质	xgzy
下周	oxnh
耳机	begn
分支	mfyx
自助	cmgs
就是个	xfi
股份制	kiq
瞧瞧	mymy
午饭	qwmz
只怕	omyu
最大限度	fdpr
酱油	qbve
月光	kyet
办好	smxi
增添	hkvt
鲜花	rmhi
穴位	axiw
兴建	zmbh
自愿	cmzu
排水	jbzs
矩阵	ejpy
不同程度的	mnmu
超出	rmvc
出身	vcps
缺损	qtjo
要命	dxao
末日	qmfr
地产	huwc
团长	zjyc
军区	ayjx
暗示	fwns
淡然	vwbu
世界各国	unwz
发烧	nfwl
近来	drqk
违纪	wpse
所占	zriz
龙飞	glge
一国	tyze
一味	tyoq
腹泻	keva
在路上	gbi
商人	nsir
考完	evaj
背叛	klcz
停了	ixdj
降温	pwvf
坚实	axao
内衣	knpy
结晶	skff
知道吗	eqo
依次	ipef
玩玩	ejej
这个是	wif
走着	rzmm
笑笑	ncnc
市场化	phi
平行	hkdl
景区	fxjx
留着	pmmm
高跟	xgbk
十字	ysai
睁开	mmth
向外	uobi
数目	kxmm
也比	uylb
隐患	pmoo
推理	jyeh
颁发	mtnf
物理学	qez
无辜	hipw
马车	zmyc
总要	kodx
确实是	taf
那份	lpim
肠道	klqc
这会	wria
药学	hszi
连连	yryr
颇有	gtgk
山上	wsit
款式	hnlv
平方公里	htmh
出路	vcbw
困惑	zglo
赢了	pddj
拜年	jtev
食欲	fswf
起诉	reud
要按	dxjy
上周	itnh
我决定	jea
直肠	ygkl
转速	ywgo
功力	vssl
躲在	pngh
适度	arrh
事后	joko
也还	uymr
分期	mfmk
下手	oxjs
只知	omeo
农村经济	bgsv
计划生育	ulcp
城里	hlhl
增进	hkur
双向	xxuo
中国经济	ozsv
监视	andu
光滑	etvy
车型	ycta
开支	thyx
控股	jako
科技进步	mjur
前所	qxzr
第三次	nce
声道	rsqc
生殖	cmby
一点都不	tiem
满满	vhvh
吃惊	oeyx
许可证	uju
古人	pgir
白痴	ubfe
周恩来	nzq
剧烈	rpba
超过了	rjd
睫毛	mtqm
共同努力	anxs
宣言	atuy
未成	qwle
高一	xgty
不了解	mdm
召唤	mzom
大面积	dtm
所有权	zgg
牢固	aqzp
内膜	knki
螺旋	cntd
结肠	skkl
也给	uysa
不会是	mif
嗯嗯	ozoz
开发利用	tnmj
南非	xqbf
突发	adnf
高质量	xzf
传达	iwdr
守护	ajjq
去除	hvpv
也同	uynt
所学	zrzi
抗菌	jphz
一定程度上	tami
对本	xjgt
有望	gkpk
实践证明	abuf
看不出	jmv
电视台	fdv
所不	zrmb
雪地	zbhu
义务教育	uwep
掩饰	jdme
一分钟	tml
全国各地	szwh
事迹	jorr
凡事	nujo
油菜	vehe
动摇	asje
不死	mbbl
管理局	ner
马来	zmqk
转型	ywta
下巴	oxvb
致力于	tsh
点评	ituh
剧情	rpyl
只能是	ovf
紫色	rlmv
贯穿	odat
就对	xvxj
医务	jews
狂欢	qexf
征服	dtkp
想到了	gtd
财政部	dtw
县级	gvsl
定时	atfj
介意	iawf
西部地区	dwhj
活血	vaci
个多月	ibk
白云	ubay
师资	atef
播出	jcvc
为学	eszi
门票	nmdn
截止	ylrz
协同	ysnt
草地	hfhu
腺癌	kufo
要知道	deq
全心	sqcx
流氓	vppe
打断	jxki
无知	hieo
意思是	wnf
梦里	ybhl
番茄	ckhw
挑选	jeqa
浏览	vwan
以来的	bqu
缘分	somf
西湖	dxvp
歌词	jjue
登上	btit
公安机关	mygk
一瓶	tyqh
还不如	mmx
心事	cxjo
排行	jbdl
向下	uoox
他家	iuaq
这方面的	wttu
竟是	ojft
抑郁	jpgk
忠诚	ovul
正规	tryu
班主	eypz
宽度	ahrh
固然	zpbu
直辖	ygya
一齐	tywa
人道	irqc
快捷	ytjt
穿衣	atpy
启示	qons
当日	ebfr
旅游业	tvo
小米	vxkm
终点	swit
所有制	zgq
大火	ddwh
服饰	kpme
真情	ygyl
多余	bbvy
教堂	eizh
管理制度	neqr
工序	vgrs
国家级	zas
包裹	sbpf
有病	gkft
慈善	qsmq
中共中央政治局	oaor
养护	mujq
掏出	jsvc
小姑	vxxp
燃料	wukk
家园	aqzj
你得	imdf
早晚	fyfm
魔术	rygu
或者是	lef
摄像	jbie
确切	tmlm
打下	jxox
回想	zogm
横向	gauo
推向	jyuo
弥漫	cmvf
严密	ocac
就不是	xmf
违背	wpkl
固定资产	zaew
专科	wvmk
包围	sbzw
复查	efgf
领导小组	ievs
忙着	ypmm
汉子	vxiz
往后	dpko
诚实	ulao
成型	leta
下发	oxnf
鼠标	ubgn
率领	psis
急忙	mbyp
不平衡	mhd
医师	jeat
年头	evot
是一位	fti
血糖	cikr
司令	etis
个头	ivot
瑞典	ewna
今天晚上	itfi
走廊	rzru
别忘	kapc
这些年	wre
气血	aqci
心电图	cfz
又把	xyjv
牵引	dacv
胸口	ksok
筹码	nktz
此前	rlqx
简直是	nyf
尖叫	vdoy
下个	oxiv
鲜血	rmci
化合	ilao
六月	pmky
路口	bwok
充电	pafi
矿物	trqs
太原	duzu
来过	qkjr
社会主义市场经济体制	dipq
很低	dkip
入学	cuzi
可真	jkyg
侧面	idtc
却无	hvhi
科普	mkqo
手套	jsdd
销量	left
出资	vcef
先是	qaft
活泼	vavn
血栓	cigs
录像	bzie
中医药	ojh
建设有中国特色社会主义	bugu
世人	usir
争议	mbuu
为生	escm
不舍	mbap
非线性	bsy
一定能	tav
忧郁	yigk
也只有	uog
向来	uoqk
键盘	lbbi
从容	iiaw
心脏病	ckf
充值	paiy
打个	jxiv
大中型	dot
未曾	qwkv
抽烟	jewz
互补	topi
于今	hyid
人影	irfv
此人	rlir
上眼	itmk
平原	hkzu
已知	eyeo
流变	vprx
哇哈哈	ooo
新生儿	nca
答道	naqc
心声	cxrs
叫了	oydj
资讯	efug
上床	itrg
候选	irqa
之地	gzhu
一世	tyus
会做	iaip
坐标	iign
施行	tudl
长发	ycnf
救助	zugs
吸取	olbx
刻意	sawf
各省	wgmm
两方	zltf
中旬	ovsf
双边	xxsr
法轮功	vyv
合肥	aokv
大城市	dhp
很累	dkns
散步	akrm
田间	ntnf
精密	klac
书店	dpri
所做	zrip
灌溉	vhvk
可以了	jbd
做饭	ipmz
不走	mbrz
可能在	jvg
默默地	ddh
点钟	itlo
急需	mbzt
后勤	kohm
总局	kore
应该说	ruu
指令	jlis
更重要的是	xadf
再回	enzo
农田	bqnt
水产	zswc
本国	gtze
党和国家	zmza
阶层	pira
无处	hiwi
干旱	hgfh
我记得	jud
怎么也	kcu
选取	qabx
难看	xyjm
没那么	vlc
粗糙	kgkk
失踪	esba
外国人	bzi
配方	detf
疑问	leno
勇于	sjhy
灵敏	bweo
一刀	tymd
业余	oyvy
八个	mbiv
并进	qhur
轻微	ybfn
凭借	isia
担忧	jfyi
好坏	xihm
一趟	tyre
纲要	sndx
避开	rwth
只是个	ofi
远方	jrtf
阴谋	pkuh
达标	drgn
园区	zjjx
实际上是	apif
限于	pkhy
主要内容	pdka
不觉得	mzd
武术	tlgu
流出	vpvc
出新	vcnd
不至	mbtv
全过程	sjm
这是一种	wftm
租赁	mgis
县城	gvhl
肝炎	khww
从实	iiao
高水平	xzh
中国社会	ozdi
侦查	iigf
老虎	elqn
平平	hkhk
举起	zmre
从头	iiot
再就业	exo
湖南省	vxm
十一月	ytk
手脚	jskh
胎儿	kvae
大体	ddig
摘要	jndx
一连	tyyr
暖暖	fefe
应尽	rzae
非要	bfdx
在任	ghis
层层	rara
就够	xvso
传媒	iwxh
楼上	gkit
命题	aofr
保安	ioya
为什么会	eici
见识	ujuo
骨头	ygot
若有	hggk
工农	vgbq
势必	pscc
发展趋势	nrrp
诸葛	uehs
受理	exeh
民兵	eldm
常识	zbuo
上一个	iti
那么大	lcd
做成	iple
只能说	ovu
一种是	tmf
就诊	xvui
居然是	rbf
舌头	asot
谁会	uyia
在校	ghgp
不允	mbva
管理者	nee
好意	xiwf
开采	theg
蜜蜂	accw
哎呦	ohos
增加到	hwt
太空	duav
很棒	dkgu
九十	kjys
染色体	vmi
传出	iwvc
掌声	zjrs
国债	zeim
户外	qhbi
质量管理	zfne
重要内容	adka
传授	iwje
业内	oykn
黑夜	dhpi
制造业	qko
负债	ifim
路边	bwsr
止血	rzci
毁灭	uvtw
件事情	ijy
一朵	tyng
插入	jacu
监狱	anqd
约占	ssiz
仓库	jcry
拜托	jtjc
人情	iryl
做不到	imt
负面	iftc
反抗	zxjp
经济损失	svje
这块	wrht
亲情	nqyl
一脚	tykh
传动	iwas
发光	nfet
怎么就	kcx
再有	engk
录音	bzwf
芒果	hpfg
回避	zorw
相互作用	gtij
小明	vxfk
她自己	xce
肢体	kyig
讲了	uudj
乃是	lnft
专业化	woi
认真学习	uyze
不是一个	mfti
傍晚	iwfm
神经元	dsj
一发	tynf
经济体制	sviq
赞美	qqmd
不服	mbkp
内分	knmf
七月	lqky
班主任	epi
为人民服务	eiew
片段	tpdo
能为	vkes
耐药	tihs
切开	lmth
几时	njfj
这说明	wuf
嫌疑人	xli
武警	tlhw
都已经	ees
好么	xicv
不良反应	muzr
谈谈	uwuw
翅膀	yxkw
混蛋	vfdr
定律	atdb
银子	lkiz
搞定	jxat
离心	wzcx
在行	ghdl
这还	wrmr
戒指	lhjl
终端	swww
预报	sxjp
裙子	pbiz
了如	djxo
发布会	ngi
这是因为	wfze
大概是	dgf
地方政府	httr
高分	xgmf
主教	pzei
不重要	mad
部件	woiq
肾功能	avv
社会效益	dipq
带了	madj
任何事	iij
低价	ipii
爸爸妈妈	rrxx
发芽	nfht
其后	mqko
夺得	djdf
并用	qhjy
兵器	dmoo
据报	jrjp
这个好	wix
那段	lpdo
吸附	olpi
该项	usvt
与世	syus
芝麻	hgry
那可	lpjk
这样的人	wgui
不允许	mvu
机组	gnsg
有兴趣	gzr
倒入	itcu
怎么做	kci
十九	yskj
那么好	lcx
海水	vezs
说明了	ufd
微机	fngn
恰当	yaeb
万分	temf
星空	fcav
社会生活	dicv
雕塑	nhkk
而非	tibf
大臣	ddjv
那也	lpuy
古巴	pgvb
按时	jyfj
故乡	pwsc
教会	eiia
微观	fnxu
公元	mvjy
大明	ddfk
却也	hvuy
首批	qcjl
小三	vxcs
据介绍	jis
政务	trws
老太太	edd
高贵	xgcg
头疼	otfw
打出	jxvc
税务所	mwz
听到了	otd
嗓子	oxiz
化为	iles
观赏	xuzd
大吉	ddkj
心意	cxwf
职位	boiw
断了	kidj
涌现	vseu
想见	gmuj
身形	psth
儒家	izaq
抽出	jevc
歌声	jjrs
快速发展	ygnr
艰苦奋斗	xhdk
却很	hvdk
利用率	mjp
描绘	jhsi
细腻	snkl
来啦	qkoj
孙子	iviz
开来	thqk
圆形	zoth
上映	itft
预备	sxwn
发短信	nei
还差	mrmv
这年	wrev
杆菌	ghhz
两家	zlaq
赛季	aumi
表白	mqub
应该有	rug
很像	dkie
这套	wrdd
开业	thoy
注射液	vpv
带到	math
革新	cgnd
一个字	tia
电极	figl
在这方面	gwtt
崭新	wynd
组织部	ssw
这片	wrtp
火箭	whnq
特别是在	qkfg
木材	gmgj
面试	tcul
难点	xyit
明亮	fkxn
遇到了	ntd
缺氧	qtam
传送	iwkd
抵制	jpqn
调度	unrh
玛丽	eztn
都必须	ecq
轨迹	ykrr
也使	uyix
眉头	rmot
得起	dfre
绍兴	smzm
不留	mbpm
碉堡	tnio
被评为	pue
首脑	qckw
胳膊	kwkj
辞职	awbo
谴责	ucmd
人民生活	iecv
烟花	wzhi
输了	yadj
可以是	jbf
一家人	tai
怎么可能	kcjv
什么了	icd
配制	deqn
好痛	xifs
丰收	kfyw
尖锐	vdlk
固执	zppz
光彩	eteg
用途	jyvr
怎么这么	kcwc
怀着	ymmm
一个小时	tivf
伊斯	ibmd
各组	wgsg
皮下	gpox
华东	ilyv
硬盘	txbi
最后一次	fkte
拉手	jwjs
地下水	hoz
不离	mbwz
珠宝	eqae
北京大学	kxdz
国际化	zpi
吃东西	oyd
只因	omzd
所见	zruj
阿胶	pjkp
领土	isht
公交	mvpr
化合物	iaq
熊猫	vlqh
取向	bxuo
公认	mvui
至此	tvrl
不忍	mbmu
心酸	cxdv
可恶	jkoc
最主要	fpd
下属	oxrc
评分	uhmf
曾有	kvgk
设有	uogk
兰州	qwsz
丢失	ates
小康社会	vrdi
可就	jkxv
首位	qciw
死在	blgh
走近	rzdr
多样化	bgi
不均	mbhs
疑惑	lelo
化妆品	iqo
一抹	tyjq
坏人	hmir
不晓得	mfd
怀中	ymov
那家	lpaq
胰岛	kdew
品味	oooq
有他	gkiu
岩石	wtts
这一年	wte
尾巴	rqvb
嘲笑	oync
偏差	iqmv
颈部	bvwo
就该	xvus
手表	jsmq
备用	wnjy
传统文化	iswi
固有	zpgk
基础教育	mtep
八月	mbky
社会各界	diwn
法律法规	vdvy
无视	hidu
这篇	wrnq
万里	tehl
排斥	jbdu
客车	awyc
他俩	iuiz
不加	mbwj
骑士	zdhs
成份	leim
一惊	tyyx
国际社会	zpdi
源于	vzhy
两部	zlwo
世界经济	unsv
推销	jyle
西装	dxqh
同感	ntlt
膝盖	kgmi
在办	ghsm
防御	ptde
政党	trza
一等奖	tnq
屋顶	rtxt
承载	dzyl
增收	hkyw
分割	mfao
一共	tyam
此间	rlnf
胆固醇	kzd
九月	kjky
格格	gwgw
无锡	hilf
扭曲	jofa
结石	skts
学问	zino
愚蠢	nnuc
直觉	ygzu
梦幻	ybse
步行	rmdl
走得	rzdf
硬度	txrh
一个国家	tiza
考古	evpg
尽头	aeot
不忘	mbpc
预定	sxat
那一刻	lts
良种	ukmo
因其	zdmq
来源于	qvh
想来	gmqk
告知	kgeo
根源	gkvz
阿富汗	pav
乒乓	dcdu
二月	weky
笨蛋	ngdr
捐赠	jodk
均无	hshi
思索	ncya
黑人	dhir
人手	irjs
日中	frov
不高兴	mxz
普通话	qsu
八卦	mbbi
这使	wrix
熬夜	ftpi
油田	vent
可不可以	jmjb
老娘	elxu
小偷	vxia
殖民	byel
标签	gnna
占了	izdj
后代	komd
灾区	awjx
统统	spsp
畅通	fvsj
尚有	esgk
法则	vhda
有天	gktd
羊肉	myki
罪恶	cboc
完全可以	asjb
入世	cuus
编织	sqso
自家	cmaq
了不起	dmr
将它	qbal
对它	xjal
支队	yxpi
杰出	gtvc
是何	ftij
片面	tptc
书房	dpqt
便会	ixia
应急	rzmb
胰岛素	kem
园林	zjyl
极少	glms
将为	qbes
年起	evre
一棵	tygf
拆迁	jdar
抗战	jpil
阻滞	pgvm
总产值	kwi
奶茶	xlhi
心上	cxit
一个问题	tinf
震动	zzas
生命力	cas
袜子	pqiz
玩笑	ejnc
握住	jrip
清华大学	vidz
台上	voit
吃点	oeit
生涯	cmvz
行程	dlmo
问问	nono
深远	vajr
派人	vzir
等功	nhvs
发掘	nfjr
欢喜	xfkq
建立健全	bwis
党建	zabh
河流	vjvp
三中全会	cosi
自学	cmzi
特意	qhwf
称赞	mmqq
为民	esel
举动	zmas
栏目	gqmm
老家	elaq
化肥	ilkv
阵地	pyhu
派出所	vvz
呆了	ogdj
颁奖	mtqb
该市	uspb
每一个人	etii
愈来愈	aqa
没看到	vjt
行列	dlba
损坏	johm
管理办法	nesv
日出	frvc
忍耐	muti
消化道	viq
太美	dumd
信用卡	iji
开办	thsm
第一位	nti
养猪	muqe
北风	klnf
全程	sqmo
万事	tejo
车展	ycra
未知	qweo
利息	macm
我倒	jlit
爬上	rvit
敢不敢	dmd
不怎么	mkc
一切都是	tlef
姨妈	xdxz
阁下	nwox
不久前	mmq
钢板	lngz
亮相	xngm
青海	lqve
赞赏	qqzd
轻轻地	yyh
冒出	fmvc
碰撞	tqjw
日常生活	fzcv
二手	wejs
靠谱	kbuq
近几年来	dneq
思想上	ngi
体会到	iit
书面	dptc
自然资源	cbev
威武	lttl
组长	sgyc
得罪	dfcb
首届	qcre
太久	dumu
花费	hica
假冒	irfm
运动会	aai
主动脉	pak
掉下	jiox
携手	jyjs
石膏	tsxk
人选	irqa
得过	dfjr
债券	imnm
要了	dxdj
的哥	usjj
积极参与	mgvs
不耐	mbti
缝合	swao
步入	rmcu
喃喃	oxox
虚伪	qoie
中国科学院	ozmp
头顶	otxt
起源	revz
打量	jxft
防疫	ptfo
将我	qbjl
值班	iyey
做出了	ivd
正处	trwi
兼并	qbqh
几乎是	ncf
仅售	ixyo
微量	fnft
手掌	jszj
遏制	fsqn
真人	ygir
党的建设	zubu
可乐	jkpv
暧昧	fefq
发给	nfsa
并可	qhjk
成形	leth
界定	niat
榜样	gwgm
妇人	xbir
它能	alvk
外侧	biid
不计	mbuy
全面建设	stbu
附图	pizw
房门	qtnm
直观	ygxu
光线	etst
中性	ovyc
勤奋	hmdn
十万	yste
牵挂	dajb
和数	mokx
总部	kowo
却被	hvpg
大公	ddmv
化解	ilmj
制动	qnas
小姑娘	vxx
赢得了	pdd
买个	doiv
我承认	jdu
应变	rzrx
不惜	mbya
归来	abqk
大姐	ddxg
长途	ycvr
征求	dtzu
关爱	kdeg
谁知道	ueq
攻关	vwkd
中分	ovmf
窒息	atcm
讽刺	ungn
大白	ddub
所要	zrdx
反之	zxgz
世贸	uspm
配件	deiq
东南亚	yxo
讲解	uumj
我见	jluj
迅速发展	ggnr
也需	uyzt
意愿	wfzu
有一个人	gtii
见证	ujut
减灾	elaw
怎么看	kcj
对这个	xwi
前辈	qxby
吓死	oobl
西门	dxnm
修理	iweh
海岸	vewz
不断发展	mknr
状态下	qdo
写得	asdf
多样性	bgy
院士	pahs
增长率	hyp
脱落	kkpw
结算	sknm
试着	ulmm
今生	idcm
就睡	xvma
不负	mbif
三维	cssy
判定	caat
聘请	beul
亦不	rymb
服药	kphs
的姐	usxg
远了	jrdj
死于	blhy
少许	msuq
实物	aoqs
海拔	vejn
期货	mkil
国企	zeir
才好	jcxi
披露	jgzb
荣获	xghq
已经开始	estx
多少钱	bml
也成	uyle
是一样	ftg
被认为	pue
彩虹	egcv
明确规定	ftya
有条件	gwi
于人	hyir
一个星期	tifm
蓝天	hatd
职业教育	boep
呼呼	ococ
我愿意	jzw
是怎么回事	fkcj
无心	hicx
抱住	jsip
力求	slzu
或者说	leu
理财	ehdj
齿轮	riyi
底部	rpwo
饿死	mjbl
谈论	uwui
敢说	dbuk
巧妙	vvxm
流传	vpiw
城市化	hpi
中小学生	ovzc
毛巾	qmbj
癌细胞	fsk
火星	whfc
目录	mmbz
有价值	gii
挂着	jbmm
正因为	tze
感恩节	lzh
背上	klit
煤矿	whtr
虽有	osgk
经济结构	svsg
粘连	kiyr
最常	fbzb
春运	ufar
菲律宾	hda
阿根廷	pgs
美妙	mdxm
和合	moao
趋于	rmhy
顽强	jtco
黄瓜	aerg
复旦	efft
二十四	wyz
滋润	vqvn
有个人	gii
啧啧	omom
碎了	tpdj
景点	fxit
又无	xyhi
之日	gzfr
太少	dums
睡吧	maov
听话	odua
乳房	eiqt
闪烁	niwp
非常好	bzx
随手	pgjs
浸泡	vbvs
发呆	nfog
竣工	wvvg
干活	hgva
几分钟	nml
周日	nhfr
度假	rhir
零食	zifs
倒数	itkx
大大提高	ddjx
也因	uyzd
寒假	auir
微小	fnvx
能吃	vkoe
虚假	qoir
头部	otwo
中枢	ovgj
科技成果	mjlf
到时候	tfi
软弱	yfce
不求	mbzu
告诉她	kux
病房	ftqt
电阻	fipg
击败	hzdw
延安	crya
当真	ebyg
她知道	xeq
直辖市	yyp
糊涂	kpvv
定性	atyc
患病	ooft
词汇	uevj
墙壁	hyrw
央视	tydu
这个世界上	wiui
扭转	joyw
打折	jxjd
电气	fiaq
信赖	iugo
存在于	ggh
传导	iwej
街旁	dbwt
钢筋	lnnk
根本没有	ggvg
要不是	dmf
硬化	txil
木有	gmgk
可不是	jmf
前去	qxhv
伴随着	ipm
转为	ywes
面色	tcmv
评议	uhuu
开头	thot
出差	vcmv
表面上	mti
那双	lpxx
乳头	eiot
爱护	egjq
财力	djsl
交替	pryy
香味	mfoq
事业单位	joki
红旗	svtm
助理	gseh
上海人	ivi
狠抓	qkjr
至关重要	tkad
耳边	besr
无私	himv
宵夜	aepi
厌恶	zdoc
自称	cmmm
外形	bith
培训班	hue
本能	gtvk
写字	asai
小狗	vxqs
热心	ptcx
很大程度	ddmr
早早	fyfy
其间	mqnf
止痛	rzfs
误解	uomj
打着	jxmm
躺在床上	pgri
两个字	zia
包子	sbiz
道教	qcei
所长	zryc
本体	gtig
湿度	vfrh
主场	pzhl
过节	jrhp
锦标	lugn
图中	zwov
橡胶	gekp
缓冲	seeo
但要	ifdx
整改	gwew
最先	fbqa
在理	gheh
吼吼	oioi
农场	bqhl
大风	ddnf
同伴	ntic
站了	widj
杜绝	ghsm
要点	dxit
徘徊	dbdz
胰腺	kdku
胡子	pkiz
疯子	fniz
这一问题	wtnf
地形	huth
要脸	dxka
纠缠	sysr
可分为	jme
这么做	wci
放电	twfi
绝不会	smi
米兰	kmqw
货运	ilar
不少人	mmi
采样	eggm
汇率	vjps
防守	ptaj
一跳	tybe
虽然是	obf
总线	kost
草根	hfgk
毁了	uvdj
种人	moir
也从	uyii
不顺	mbst
为最	esfb
却只	hvom
换个	jmiv
不得了	mdd
老化	elil
来着	qkmm
早饭	fymz
人造	irkr
科学院	mzp
歌唱	jjof
前三	qxcs
搜集	juyg
上岗	itwn
入睡	cuma
言论	uyui
中度	ovrh
线条	stwg
猛然	qibu
两张	zlcy
海鲜	verm
两边	zlsr
任命	isao
接轨	jwyk
我应该	jru
不讲	mbuu
细心	sncx
应以	rzby
又到	xyth
公约	mvss
各族	wgte
一招	tyjm
看了看	jdj
东风	yvnf
男主	nspz
督促	ixib
粉红	kmsv
晶体	ffig
媒介	xhia
为难	esxy
甚么	micv
最短	fbet
安徽省	yfm
在此基础上	grmi
拿出来	avq
一言	tyuy
元钱	jylt
两个方面	zitt
三四	csza
齐全	wasq
反动	zxas
自卑	cmub
强劲	cobv
售出	yovc
特地	qhhu
抢劫	jjhv
肺炎	ktww
代表性	mmy
请我	uljl
肾上腺	aik
平滑肌	hvk
招呼	jmoc
删除	sapv
停在	ixgh
这般	wrbo
留意	pmwf
魔鬼	ryua
通宵	sjae
今天上午	itiq
精英	klht
电器	fioo
六年	pmev
气味	aqoq
不屑	mbre
重要原因	adzz
那些人	lri
致命	thao
不经意	msw
况且	eogq
非公	bfmv
皱纹	mbsw
宝石	aets
突击	adhz
三明	csfk
而被	tipg
体贴	igdi
同性	ntyc
金陵	sjph
见解	ujmj
病史	ftox
届时	refj
女王	xnew
熟练	xksl
副市长	ppy
小腿	vxkk
也应该	uru
支持下	yjo
自以为	cbe
清热	vlpt
几个方面	nitt
虽说	osuk
首选	qcqa
这样子	wgi
对党	xjza
冷冻	eiey
不可避免	mjrm
眼下	mkox
向后	uoko
内存	kngi
不只是	mof
秋季	mwmi
在一定程度上	gtai
实效	aopr
你不知道	imeq
证明了	ufd
别让	kaui
突然发现	abne
显然是	fbf
总不	komb
阻断	pgki
石化	tsil
并为	qhes
美帝国主义	mwzu
如一	xoty
沉思	vanc
下半年	oce
脊柱	kagp
商检	nsga
收支	ywyx
星期六	fmp
转过身	yjp
活的	vaus
据此	jrrl
分流	mfvp
粘土	kiht
烧烤	wlwe
现在已经	eges
将近	qbdr
跟随	bkpg
驾驶员	wzo
实惠	aohf
这是个	wfi
分量	mfft
制裁	qnyl
认真贯彻	uyod
务实	wsao
他觉得	izd
结实	skao
只觉	omzu
手册	jssc
了之	djgz
先前	qaqx
拳头	njot
吩咐	omoi
没收	voyw
空虚	avqo
吃什么	oic
绝对的	sxu
想听	gmod
纲领	snis
毫米	xqkm
血性	ciyc
自然界	cbn
储存	iugi
经销	sble
高了	xgdj
班长	eyyc
暗恋	fwrc
补助	pigs
人大代表	idmm
寄生	adcm
民工	elvg
我们能	jiv
宠物	agqs
红酒	svvd
硫酸	tpdv
枕头	gbot
车祸	ycdo
简洁	nnvk
救灾	zuaw
两方面	ztt
相近	gmdr
出事	vcjo
却还	hvmr
含水	idzs
跑去	bshv
日内	frkn
发票	nfdn
病原	ftzu
降至	pwtv
院子	paiz
刘海	wave
蒙古	xwpg
开水	thzs
一角	tymj
子弹	izck
服务业	kwo
有本	gkgt
公款	mvhn
必有	ccgk
滚动	vpas
视察	duab
握手	jrjs
社交	dhpr
评审	uhaf
高素质	xmz
只知道	oeq
暖和	femo
相伴	gmic
珠海	eqve
了呀	djot
迁移	armb
筷子	nyiz
扩建	jrbh
迹象	rrex
指望	jlpk
觉悟	zuyc
试样	ulgm
批量	jlft
怪不得	ymd
宴会	afia
标识	gnuo
回到了	ztd
没问	vono
就是这个	xfwi
昏迷	plkr
那一天	ltt
大雨	ddzy
坚信	axiu
起伏	reid
小鸟	vxen
分别是	mkf
毛毛	qmqm
有计划	gul
美白	mdub
暴雨	fazy
成员国	loz
辨证	wyut
人类社会	ikdi
国防部	zpw
大大的	ddu
两项	zlvt
账户	dyqh
合格率	agp
多说	bbuk
缘故	sopw
相关性	gky
港澳	vavu
两侧	zlid
也觉得	uzd
天然气	tba
有能力	gvs
调解	unmj
世界里	unh
好过	xijr
铁道	leqc
留言	pmuy
协定	ysat
第二名	nwb
身躯	pspj
黑衣	dhpy
降价	pwii
职业道德	boqd
请不要	umd
天内	tdkn
要将	dxqb
就是我们	xfji
脸颊	kayk
文人	wwir
陌生的	pcu
惟一	yyty
抗拒	jpjj
相见	gmuj
而你	tiim
探测	javd
金色	sjmv
锦标赛	lga
在旁	ghwt
放不下	tmo
为的	esus
犀利	rzma
表扬	mqjl
好心情	xcy
摄影师	jfa
载荷	ylhi
烟叶	wzoy
这货	wril
分歧	mfry
快到	ytth
腹痛	kefs
张开	cyth
广泛应用	rvrj
之旅	gztc
痉挛	fbrj
来做	qkip
外伤	biie
繁华	ewil
开着	thmm
西岸	dxwz
报酬	jpds
安理会	yei
结节	skhp
可看	jkjm
根本利益	ggmq
不由得	med
刊物	haqs
早知	fyeo
市中心	poc
政府部门	trwn
下岗职工	owbv
轻声	ybrs
农业部	bow
发誓	nfjd
终止	swrz
显效	fopr
白衣	ubpy
额头	awot
下游	oxvt
骨质	ygzy
抗病	jpft
在里面	ght
胚胎	kmkv
夕阳	bxpf
推测	jyvd
大为	ddes
花粉	hikm
很清楚	dvy
与她	syxu
为毛	esqm
最重要的是	fadf
机能	gnvk
虽不	osmb
月初	kypm
出行	vcdl
孵化	peil
急剧	mbrp
一帮	tykp
空军	avay
做完	ipaj
多功能	bvv
喜剧	kqrp
椎间盘	gnb
庆幸	rdhq
畜牧业	sqo
白血	ubci
帮帮	kpkp
背着	klmm
莫非	imbf
必须是	cqf
堵塞	heau
保险公司	ipme
前天	qxtd
先进性	quy
选择性	qjy
更能	xfvk
多小时	bvf
短缺	etqt
流露	vpzb
打架	jxwg
刊登	habt
第三名	ncb
思绪	ncse
汉字	vxai
协调发展	yunr
星期五	fmc
甘心	htcx
并能	qhvk
第三个	nci
使用权	ijg
相思	gmnc
公安部	myw
踏实	bzao
就将	xvqb
政治上	tvi
这几年	wne
高出	xgvc
隐隐	pmpm
显现	foeu
变更	rxxf
两句	zlso
回首	zoqc
邮政	eptr
滥用	vnjy
本地区	ghj
黄昏	aepl
降到	pwth
爬起	rvre
毒品	mooo
原地	zuhu
拍拍	juju
十几年	yne
蒸发	hdnf
上百	ittf
呼吸道	ooq
而今	tiid
各行	wgdl
未婚	qwxp
您好	imxi
器材	oogj
也不错	uml
大喊	ddol
政法	trvh
深爱	vaeg
赞扬	qqjl
自来	cmqk
人家的	iau
太快	duyt
吓人	ooir
也只是	uof
求得	zudf
解脱	mjkk
招待会	jdi
句子	soiz
前夕	qxbx
使你	ixim
要紧	dxax
要靠	dxkb
猴子	qriz
无须	hiqt
张大	cydd
重要因素	adzm
最基本	fmg
无名	hibo
下楼	oxgk
累死	nsbl
女郎	xnuk
同比增长	nlhy
不佳	mbib
常有	zbgk
掌门	zjnm
衰竭	powf
对于我	xhj
克林顿	pyl
旅馆	tcma
表述	mqgu
手腕	jska
冬日	wefr
戴着	ylmm
六点	pmit
西红柿	dsg
大伙	ddiw
报表	jpmq
怀抱	ymjs
哮喘	oeow
很多时候	dbfi
赶来	rhqk
装配	qhde
优惠政策	ihtn
金正	sjtr
追逐	urqr
看那	jmlp
行政部门	dtwn
构筑	gsnv
社会稳定	dima
库存	rygi
洗脸	vqka
侵权	ibgx
倘若	iehg
我们不能	jimv
指南	jlxq
水准	zsey
贴近	didr
更强	xfco
前所未有	qzqg
都需要	ezd
作出的	ivu
千元	aqjy
相当的	geu
进球	urez
上山	itws
就算是	xnf
综合治理	save
十五大	ycd
班级	eysl
照相	fmgm
脑残	kwbt
可供	jkia
漳州	vosz
成为了	led
其内	mqkn
吃好	oexi
五千	cwaq
葡萄糖	hhk
系好	csxi
曲折	fajd
近似	drib
神经病	dsf
和风	monf
暗暗	fwfw
其中包括	mosj
到老	thel
摄入	jbcu
高山	xgws
认出	uivc
根治	gkvv
店里	rihl
很冷	dkei
但那	iflp
而生	ticm
如此的	xru
物业管理	qone
各级党委	wszm
在职	ghbo
后进	kour
他就是	ixf
造价	krii
深深地	vvh
前沿	qxvn
奔驰	dyzu
万岁	tewb
没心	vocx
现实生活	eacv
扬州	jlsz
服务员	kwo
而应	tirz
罪犯	cbqe
雪花	zbhi
信不信	imi
公爵	mvek
航班	bpey
树木	gxgm
拜访	jtut
世贸组织	upss
重要讲话	aduu
年末	evqm
尚书	esdp
心情不好	cymx
药剂	hswa
天鹅	tdjl
在听	ghod
社会主义现代化建设	dipu
步步	rmrm
浓厚	vbzf
多重	bbah
山西省	wdm
害羞	akmo
侵害	ibak
文革	wwcg
全心全意	scsw
我们应该	jiru
夺取	djbx
接入	jwcu
重口	ahok
名誉	bozm
看似	jmib
降解	pwmj
大步	ddrm
了嘛	djor
不公平	mmh
胶囊	kpyo
谈恋爱	ure
朝着	yymm
常委会	zmi
火爆	whwf
研究成果	talf
躺着	pemm
迷失	kres
关键的	klu
印尼	pprl
效能	prvk
号线	ovst
便秘	ixmc
想死	gmbl
高举	xgzm
车厢	yczg
巴基斯坦	vmmh
伤亡	iepw
有毒	gkmo
准时	eyfj
房里	qthl
工件	vgiq
人世	irus
走走	rzrz
切断	lmki
区内	jxkn
太棒	dugu
骂人	ooir
有气	gkaq
设在	uogh
凭什么	iic
中国古代	ozpm
乒乓球	dde
受贿	exdg
等候	nhir
里程	hlmo
事情的	jyu
逮捕	bzjj
升到	chth
比分	lbmf
公用	mvjy
颗星	fgfc
议员	uuod
辆车	yzyc
不睡	mbma
军官	ayau
早上好	fix
直接的	yju
并不能	qmv
相信自己	gice
微软	fnyf
再现	eneu
寻常	bjzb
饭后	mzko
这叫	wroy
三亚	csoy
外人	biir
一小时	tvf
海底	verp
贫穷	mdas
书写	dpas
郊区	prjx
地层	hura
杀伤	xgie
挤出	jwvc
字母	aiom
第三产业	ncwo
社会中	dio
七个	lqiv
大头	ddot
把头	jvot
其次是	mef
我告诉	jku
很大程度上	ddmi
抽取	jebx
花朵	hing
电台	fivo
当家	ebaq
还算	mrnm
趣味	rboq
数千	kxaq
容器	awoo
可以的	jbu
反腐败斗争	zrdm
创立	jawl
本世纪	gus
做到了	itd
规矩	yuej
剧本	rpgt
从哪	iiol
升起	chre
交通部	psw
蘑菇	hrhx
打听	jxod
将使	qbix
掩盖	jdmi
信访	iuut
伤了	iedj
皇后	ueko
有的是	guf
为了让	edu
后又	koxy
血肿	ciko
温家宝	vaa
伪装	ieqh
底线	rpst
镇痛	lyfs
联手	bkjs
首席	qcrh
亦有	rygk
不同意	mnw
内分泌	kmv
生存率	cgp
本领	gtis
相识	gmuo
百搭	tfjh
治国	vvze
一排	tyjb
签字	naai
将达	qbdr
目的地	muh
高三	xgcs
一大堆	tdh
改革开放以来	ectq
职权	bogx
短时	etfj
即在	kpgh
交通运输	psay
粒子	kwiz
民营企业	exio
很深	dkva
千方百计	attu
红军	svay
土耳其	hbm
胸前	ksqx
因果	zdfg
受教	exei
曹操	afjo
天朝	tdyy
如果能	xfv
各种各样	wmwg
专电	wvfi
偶遇	innn
口岸	okwz
入侵	cuib
科学发展	mznr
不解释	mmc
比利	lbma
震荡	zzpl
莆田	hjnt
无耻	hibr
供电	iafi
八点	mbit
这可能	wjv
一阵子	tpi
是一些	ftr
去想	hvgm
按规定	jya
快了	ytdj
四面	zatc
重心	ahcx
不至于	mth
是啥	ftoa
门窗	nmau
查出	gfvc
下达	oxdr
救援	zuje
克拉	pajw
韧带	wpma
没有的	vgu
挂钩	jbls
伯爵	iuek
抓起	jrre
白血病	ucf
学生们	zci
每个人的	eiiu
多想	bbgm
而过	tijr
岩溶	wtva
投放	jotw
卡通	iosj
展出	ravc
模板	gigz
奇异	djeh
内侧	knid
不明显	mff
性命	ycao
个数	ivkx
停下来	ioq
这孩子	wii
平和	hkmo
董事会	hji
踏上	bzit
茫然	ppbu
克里	pahl
怎么可以	kcjb
葡萄酒	hhv
越来越大	rqrd
这么好的	wcxu
肾脏	axkr
南昌	xqff
匹配	jade
潜能	vyvk
吐了	ohdj
并把	qhjv
也别	uyka
稀饭	mxmz
矿产资源	twev
保护区	ijj
二千	weaq
也需要	uzd
柴油	rlve
复兴	efzm
感应	ltrz
献给	xdsa
胃口	nkok
刺史	gnox
集资	ygef
约有	ssgk
旋律	tddb
吃个	oeiv
拼搏	jqjj
迷茫	krpp
台风	vonf
会晤	iafc
太平洋	dhv
宁可	anjk
狐狸	qrqh
不值得	mid
点燃	itwu
目前为止	mqer
致病	thft
热门	ptnm
人民大会堂	iedz
怎会	kcia
不接	mbjw
后退	kokr
跟在	bkgh
这种情况下	wmyo
打动	jxas
了没有	dvg
更可	xfjk
巴克	vbpa
死者	blez
定向	atuo
外在	bigh
问世	nous
多有	bbgk
都不要	emd
邮轮	epyi
平民	hkel
容忍	awmu
模具	gigm
严重影响	oafo
笑脸	ncka
紫外线	rbs
七八	lqmb
一班	tyey
从业人员	ioio
关税	kdmk
并存	qhgi
乡下	scox
动静	aslm
不强	mbco
航运	bpar
凝聚力	ebs
会这样	iwg
超值	rmiy
可将	jkqb
好多人	xbi
国庆	zerd
空前	avqx
肩上	qkit
金黄	sjae
日夜	frpi
往上	dpit
马来西亚	zqdo
解决方案	mety
所需要	zzd
风暴	nffa
闪电	nifi
明日	fkfr
转到	ywth
出场	vchl
大专	ddwv
不是吗	mfo
它对	alxj
全面建设小康社会	stbi
无缘	hiso
演奏	vaut
东海	yvve
牵着	damm
彩票	egdn
减压	elzh
小吃	vxoe
器械	oogl
七年	lqev
显示器	fno
月下	kyox
无异	hieh
教育事业	epjo
石家庄	tar
如果不是	xfmf
的士	ushs
中南	ovxq
签约	nass
一生中	tco
销售额	lya
麦当劳	mex
好棒	xigu
放学	twzi
不是人	mfi
理会	ehia
星期一	fmt
总体上	kii
视角	dumj
所处	zrwi
看望	jmpk
一架	tywg
叶子	oyiz
农作	bqik
不适应	mar
转基因	ymz
基底	mhrp
创新能力	jnvs
哼哼	oxox
战役	ildo
牵手	dajs
午后	qwko
风采	nfeg
上层	itra
一开始	ttx
深沉	vava
挤压	jwzh
想有	gmgk
高原	xgzu
海报	vejp
劳务	xsws
大红	ddsv
杂种	kgmo
私营企业	mxio
宁夏	antm
开幕式	til
频频	rmrm
增幅	hkbp
蒙牛	xwqn
心目中的	cmou
倒下	itox
上线	itst
组分	sgmf
贯彻执行	odpd
死不	blmb
民政	eltr
普查	qogf
出发点	vni
知己	eoej
教委	eimx
经历过	szj
实例	aoib
裂纹	basw
一九八	tkm
之前的	gqu
不要脸	mdk
甚至是	mtf
村庄	gjrh
只可	omjk
着呢	mmor
藏在	hlgh
三者	csez
出动	vcas
所取	zrbx
就在于	xgh
一直到	tyt
技术水平	jgzh
闹钟	nplo
城市建设	hpbu
小手	vxjs
犹太	qidu
有关方面	gktt
奔波	dyvg
该是	usft
五六	cwpm
创造出	jkv
称呼	mmoc
便捷	ixjt
箱子	ngiz
七天	lqtd
重度	ahrh
眉毛	rmqm
操纵	josi
抽查	jegf
大理	ddeh
梦到	ybth
嫌弃	xqph
意图	wfzw
写信	asiu
二等	wenh
排毒	jbmo
正经	trsb
一回事	tzj
第一步	ntr
正气	traq
双人	xxir
机电	gnfi
发泄	nfvu
河道	vjqc
户口	qhok
骨科	ygmk
自律	cmdb
妨碍	xttf
教育改革	epec
心理健康	ceir
显露	fozb
心率	cxps
明明是	fff
上台	itvo
管理系	nec
再过	enjr
资质	efzy
最最	fbfb
我感到	jlt
也是一个	ufti
要被	dxpg
中国传统	ozis
小弟	vxkc
定制	atqn
撤销	jple
活检	vaga
时而	fjti
书画	dptn
好几个	xni
大类	ddkd
四方	zatf
振奋	jzdn
陛下	plox
这名	wrbo
日报	frjp
一闪	tyni
倒了	itdj
是那个	fli
誉为	zmes
诱人	umir
拥挤	jjjw
细细	snsn
不规则	myd
就那么	xlc
淹没	vdvo
不绝	mbsm
限量版	pft
揭露	jfzb
声响	rsou
固体	zpig
高等学校	xnzg
不作	mbik
无助	higs
才华	jcil
填写	hyas
弄清	ehvl
饱和	msmo
解答	mjna
坏事	hmjo
肿大	kodd
雷锋	znlw
专注	wvvp
产后	wcko
周易	nhfs
节水	hpzs
导师	ejat
是件	ftiq
慎重	yyah
气得	aqdf
风向	nfuo
超好	rmxi
一个中国	tioz
初一	pmty
加盟	wjfk
牛仔裤	qip
利于	mahy
肯定会	rai
看懂	jmyh
是什么样	ficg
趋向	rmuo
环境下	eho
织物	soqs
实地	aohu
前行	qxdl
脸庞	karg
观察到	xat
前几天	qnt
树林	gxyl
如意	xowf
边上	srit
神仙	dfiw
饮酒	mfvd
历史性	zoy
毕业后	lok
擅自	jpcm
大侠	ddiy
但因	ifzd
靠在	kbgh
投机	jogn
一节	tyhp
月内	kykn
呆在	oggh
叫什么	oic
强有力	cgs
所在地	zgh
上升到	ict
何种	ijmo
通货	sjil
经受	sbex
侵蚀	ibmc
又来了	xqd
心有	cxgk
醉了	dpdj
长寿	yckj
公车	mvyc
用以	jyby
那件	lpiq
元件	jyiq
人行	irdl
换来	jmqk
机票	gndn
纵向	siuo
四种	zamo
碎片	tptp
穷人	asir
毒素	moms
牢牢	aqaq
忠实	ovao
候选人	iqi
只有这样	ogwg
知情	eoyl
学到	zith
送礼	kddi
一首歌	tqj
日元	frjy
可选	jkqa
本性	gtyc
社会治安	divy
跑步	bsrm
笑意	ncwf
电视机	fdg
而使	tiix
但如果	ixf
会同	iant
异地	ehhu
半月	cbky
标题	gnfr
财经	djsb
农作物	biq
到过	thjr
从外	iibi
外加	biwj
坦然	hfbu
生产队	cwp
统一战线	stis
走开	rzth
奴隶	xxbz
公安局	myr
汗水	vhzs
军民	ayel
敬业	hooy
这是我们	wfji
正常人	tzi
生产过程	cwjm
难道你	xqi
空心	avcx
要向	dxuo
方言	tfuy
将被	qbpg
最大限度地	fdph
全球化	sei
不属于	mrh
原因之一	zzgt
我感觉	jlz
绿地	sbhu
愉悦	yayk
替我	yyjl
万能	tevk
还必须	mcq
而起	tire
进一步的	utru
风吹	nfof
我军	jlay
包袱	sbpd
历来	zsqk
好消息	xvc
催化	iwil
战友	ilgx
相对于	gxh
指引	jlcv
解开	mjth
留下来	poq
多方面的	bttu
而她	tixu
不善	mbmq
寂静	avlm
三项	csvt
不说话	muu
研究院	tap
不记得	mud
今年以来	iebq
父子	rfiz
很是	dkft
语法	ucvh
物料	qskk
修补	iwpi
心内	cxkn
昨天晚上	ftfi
毛细	qmsn
展望	rapk
没做	voip
多是	bbft
陈旧	pyvf
流血	vpci
那里的	lhu
新颖	ndlm
社团	dhzj
妥协	exys
了啦	djoj
植株	gygq
茫茫	pppp
转变为	yre
之于	gzhy
挽回	jmzo
来得及	qdl
炒作	wmik
今夜	idpi
又可以	xjb
过氧化	jai
党和政府	zmtr
一些地方	trht
涨幅	vcbp
弱点	ceit
船上	bnit
重大问题	adnf
十点	ysit
闭上眼	nim
能和	vkmo
不是因为	mfze
肿胀	koky
大作	ddik
所以说	zbu
不休	mbig
拿下	aoox
干部群众	hwbi
看在	jmgh
古城	pghl
选育	qapk
可信	jkiu
口头	okot
我们自己	jice
网点	nxit
渔业	vroy
后人	koir
中英	ovht
稳步	mmrm
轮廓	yirx
最新的	fnu
前人	qxir
我们已经	jies
我们现在	jieg
照明	fmfk
朝阳	yypf
所有的人	zgui
而下	tiox
诅咒	ugoo
该有	usgk
出乎	vcck
累积	nsmo
大变	ddrx
这种感觉	wmlz
教育学	epz
研究中心	taoc
动漫	asvf
严谨	ocuh
用法	jyvh
近视	drdu
由他	eyiu
铸铁	lkle
痛快	fsyt
谈起	uwre
可喜	jkkq
衷心	pocx
民主党派	epzv
社会学	diz
客体	awig
黑龙江省	dgvm
可行性	jdy
初恋	pmrc
处境	wiho
一字	tyai
截面	yltc
提案	jfyg
闻言	nbuy
青睐	lqmq
上部	itwo
歧视	rydu
深化改革	viec
核桃	gsge
绝大部分	sdwm
新一轮	nty
桂林	gbyl
啥时	oafj
别忘了	kpd
此一	rlty
全军	sqay
是靠	ftkb
封面	bjtc
委员长	moy
引用	cvjy
数控	kxja
站立	wiwl
一派	tyvz
才行	jcdl
逝世	jdus
死刑	blth
必不	ccmb
中产	ovwc
都一样	etg
即为	kpes
周四	nhza
多时	bbfj
出卖	vcyd
未成年	qle
经纪	sbse
衔接	dljw
颗心	fgcx
货币政策	ictn
要快	dxyt
沙滩	vmvx
告诉自己	kuce
家用	aqjy
白菜	ubhe
最少	fbms
采取措施	ebjt
欣慰	dfrj
品德	oody
一般人	tbi
小妹	vxxq
多项	bbvt
预告	sxkg
遗址	crhr
筹备	nkwn
在这样的	gwgu
澳洲	vuvs
赛事	aujo
关键在于	klgh
光泽	etvx
监护	anjq
眼球	mkez
长相	ycgm
特种	qhmo
春季	ufmi
本着	gtmm
担负	jfif
亲手	nqjs
弊端	kwww
对不对	xmx
真是个	yfi
此处	rlwi
同等	ntnh
瘦了	fudj
再好	enxi
放着	twmm
大户	ddqh
旺盛	fele
回味	zooq
拥护	jjjq
奇妙	djxm
不愧	mbyu
不能用	mvj
佛山	icws
没有用	vgj
恨不	ykmb
破了	tgdj
失调	esun
点滴	itvn
科技人员	mjio
削弱	ekce
器件	ooiq
社会主义建设	dipu
迟早	arfy
亲近	nqdr
不改	mbew
背景下	kfo
嘤嘤	odod
波兰	vgqw
什么事情	icjy
那么的	lcu
型号	taov
少林	msyl
蓬勃	hwyi
国外的	zbu
犯罪嫌疑	qcxl
碰上	tqit
苦难	hpxy
而死	tibl
简介	nnia
他问	iuno
着想	mmgm
民航	elbp
适应性	ary
艰辛	xkwx
央行	tydl
高跟鞋	xbc
才对	jcxj
哪天	oltd
体现出	iev
近百	drtf
要怎么	dkc
惯例	yoib
新一代	ntm
已完	eyaj
或有	logk
这本书	wgd
免得	modf
边境	srho
超标	rmgn
京剧	xvrp
笑了笑	ndn
似乎是	icf
相亲	gmnq
不满意	mvw
等同	nhnt
发展水平	nrzh
乏力	cgsl
档次	geef
它有	algk
馒头	mfot
喜欢上	kxi
喝茶	ofhi
契机	kmgn
多变	bbrx
想什么	gic
活化	vail
最初的	fpu
它与	alsy
同年	ntev
中国人民银行	ozid
自然灾害	cbaa
大选	ddqa
完后	ajko
生产率	cwp
唯物	oyqs
海内	vekn
不影响	mfo
可观	jkxu
面具	tcgm
忧虑	yiqc
通往	sjdp
胸腔	kska
八一	mbty
犀牛	rzqn
察觉	abzu
不相同	mgn
一点儿	tia
亦可	ryjk
他不是	imf
之声	gzrs
路人	bwir
主演	pzva
废水	rnzs
高层次	xre
如不	xomb
来自于	qch
说实话	uau
专心	wvcx
是一次	fte
回升	zoch
中国足球	ozbe
投影	jofv
机动车	gay
就是为了	xfed
上行	itdl
我操	jljo
懂你	yhim
超高	rmxg
或许是	luf
开阔	thnv
开出	thvc
后方	kotf
堆积	hymo
正要	trdx
脱水	kkzs
强奸	coxh
升华	chil
提议	jfuu
那不是	lmf
母猪	omqe
没完	voaj
香烟	mfwz
肯定的	rau
撰写	jeas
卡拉	iojw
历时	zsfj
猜测	qlvd
除夕	pvbx
从这个	iwi
到头	thot
光电	etfi
没必要	vcd
山羊	wsmy
跟上	bkit
写道	asqc
天亮	tdxn
九点	kjit
主机	pzgn
浮现	veeu
东莞	yvpj
长短	ycet
挂了	jbdj
周三	nhcs
浴室	vwat
奔跑	dybs
都是浮云	efva
照样	fmgm
发生过	ncj
陈翔	pymb
猛烈	qiba
敞开	ewth
转移到	ymt
数额	kxaw
也一样	utg
应激	rzvu
这么多年	wcbe
个多小时	ibvf
少于	mshy
此地	rlhu
漏洞	vrvn
已无	eyhi
吃掉	oeji
船长	bnyc
吐出	ohvc
一届	tyre
侮辱	iezq
会用	iajy
发展经济	nrsv
看得出	jdv
忍住	muip
许久	uqmu
最右	fbgo
会场	iahl
逆转	knyw
云南省	axm
堕落	pgpw
南宁	xqan
规章制度	yoqr
七点	lqit
所知	zreo
缺失	qtes
由我	eyjl
脑子里	kih
不懈	mbym
真话	ygua
权限	gxpk
医学院	jzp
留学生	pzc
变性	rxyc
之多	gzbb
大手	ddjs
并向	qhuo
不免	mbmo
先进水平	quzh
订单	uxkf
下方	oxtf
期盼	mkmm
两眼	zlmk
煤气	whaq
基金会	msi
最广	fbrg
热血	ptci
很明显	dff
要闻	dxnb
访华	util
环境污染	ehvv
纵横	siga
联网	bknx
太小	duvx
听力	odsl
太强	duco
中报	ovjp
甲基	njmh
过往	jrdp
它也	aluy
筹集	nkyg
行事	dljo
找回	jlzo
冷水	eizs
就快	xvyt
一整天	tgt
这就要	wxd
副局长	pry
电影院	ffp
根本的	ggu
工业企业	voio
私有	mvgk
什么情况	icye
立时	wlfj
博览	yjan
打球	jxez
之一的	gtu
我必须	jcq
彼此的	dru
卓越	ifrl
似地	ibhu
突然想起	abgr
犯了	qedj
迅猛	gyqi
妹纸	xqsp
龙门	glnm
不复	mbef
太棒了	dgd
已然	eybu
田径	ntdb
不长	mbyc
吃喝	oeof
这支	wryx
上提	itjf
双腿	xxkk
竞技	wojy
棉衣	gupy
设法	uovh
体谅	igux
捕捉	jjjb
植入	gycu
冒着	fmmm
防洪	ptva
不关	mbkd
乘坐	mkii
下一步	otr
最优	fbii
本土	gtht
两地	zlhu
都应该	eru
欣喜	dfkq
交互	prto
放进	twur
交通事故	psjp
流入	vpcu
人生观	icx
一九九	tkk
添加剂	vww
大力支持	dsyj
半晌	cbfu
转转	ywyw
治病	vvft
颇为	gtes
犯罪嫌疑人	qcxi
试行	uldl
经济上	svi
精神病	kdf
收敛	ywaz
这种方法	wmtv
半径	cbdb
诊治	uivv
谁在	uygh
所需要的	zzdu
上千	itaq
多点	bbit
飞跃	gebc
该怎么办	ukcs
涌动	vsas
欢呼	xfoc
风气	nfaq
女主角	xpm
伤痛	iefs
风衣	nfpy
也开始	utx
单个	kfiv
戴上	ylit
脸红	kasv
淑女	vixn
孕育	lipk
中高	ovxg
啥时候	ofi
亲眼	nqmk
又问	xyno
名词	boue
威力	ltsl
兼顾	qbze
蒸汽	hdva
则有	dagk
它可以	ajb
所以我们	zbji
家务	aqws
开学	thzi
世俗	usiw
又称	xymm
地毯	huqw
僵尸	itrs
女排	xnjb
路子	bwiz
最真	fbyg
蚊子	cwiz
天花	tdhi
没问题	vnf
十分重视	ymad
不靠	mbkb
定理	ateh
年均	evhs
进门	urnm
植被	gypg
时装	fjqh
月前	kyqx
账号	dyov
话剧	uarp
进食	urfs
音乐会	wpi
人际关系	ipkc
股价	koii
代表大会	mmdi
洗手	vqjs
经络	sbsw
史学	oxzi
明月	fkky
立马	wlzm
当做	ebip
操作系统	jics
忘掉	pcji
百合	tfao
雨水	zyzs
大吃	ddoe
豆瓣	towr
炫耀	wsea
俄国	ijze
辽宁省	dam
助学	gszi
该县	usgv
水蒸气	zha
跳出	bevc
伴侣	icio
不喝	mbof
凝血	esci
卑微	ubfn
体操	igjo
负责任	imi
半个月	cik
敏锐	eolk
临近	andr
商品房	noq
发酵	nfde
自习	cmex
综上	sait
时段	fjdo
不掉	mbji
临界	anni
这几个	wni
太重	duah
摸索	jiya
我不喜欢	jmkx
他给	iusa
相符	gmni
遵义	qjux
我明白	jfu
音响	wfou
干部队伍	hwpi
被告人	pki
任用	isjy
之余	gzvy
战斗力	iks
行政机关	dtgk
日子里	fih
迫使	urix
猫咪	qhok
握着	jrmm
麻辣	rywg
追踪	urba
但当	ifeb
宏伟	agiw
人民代表大会	iemi
打包	jxsb
第一线	nts
预言	sxuy
量化	ftil
钻进	liur
心境	cxho
达不到	dmt
东亚	yvoy
该说	usuk
编程	sqmo
机械化	ggi
受灾	exaw
膝关节	kkh
中国人的	oziu
碉堡了	tid
响了	oudj
也喜欢	ukx
品尝	ooea
新局面	nrt
幸运的	hau
来人	qkir
不变的	mru
不叫	mboy
受过	exjr
星球	fcez
也该	uyus
手提	jsjf
这笔	wrnq
废物	rnqs
是种	ftmo
均不	hsmb
两类	zlkd
放出	twvc
分娩	mfxm
新版	ndtz
毕竟是	lof
小镇	vxly
上衣	itpy
发抖	nfjk
千百	aqtf
只能在	ovg
管辖	naya
辩论	wuui
保持着	ijm
中风	ovnf
但无	ifhi
而不能	tmv
早睡	fyma
追问	urno
上报	itjp
见于	ujhy
辩护	wujq
水上	zsit
什么啊	ico
四百	zatf
它还	almr
使劲	ixbv
流星雨	vfz
收治	ywvv
潜伏	vyid
经济工作	svvi
情人节	yih
简约	nnss
诡异	umeh
就是因为	xfze
上司	itet
首发	qcnf
广州市	rsp
用不着	jmm
二三	wecs
也不过	umj
庄严	rhoc
生态系统	cdcs
答复	naef
重口味	aoo
尽早	aefy
废弃	rnph
一定有	tag
子孙	iziv
剥夺	bzdj
不问	mbno
抢购	jjds
增长速度	hygr
年老	evel
才想	jcgm
做大	ipdd
干吗	hgoz
除去	pvhv
吉他	kjiu
去哪里	hoh
平日	hkfr
种族	mote
水蛇腰	zck
天哪	tdol
换成	jmle
春风	ufnf
跑出	bsvc
黑眼	dhmk
文中	wwov
默契	ddkm
意境	wfho
热带	ptma
飞扬	gejl
意识形态	wutd
抵抗力	jjs
生理盐水	cehz
合影	aofv
真的吗	yuo
中国文化	ozwi
如在	xogh
就是这么	xfwc
红枣	svgn
判处	cawi
哇塞	obau
痘痘	ftft
原油	zuve
这些事	wrj
门人	nmir
大姨	ddxd
集团公司	yzme
可为	jkes
触及	mjlj
不料	mbkk
华北	ilkl
怪我	yxjl
兼职	qbbo
单反	kfzx
产出	wcvc
能从	vkii
不论是	muf
反省	zxmm
内阁	knnw
对内	xjkn
强力	cosl
短时间	efn
贝尔	dbmv
冲出	eovc
在它	ghal
售票	yodn
乙醇	gydx
指向	jluo
走访	rzut
肉体	kiig
入微	cufn
显微	fofn
列宁	baan
新婚	ndxp
翻身	cnps
固化	zpil
所在的	zgu
建设社会主义	budu
导致了	etd
众所周知	izne
蜡烛	cawc
在这种情况下	gwmo
之作	gzik
焊接	wfjw
太极	dugl
急于	mbhy
诠释	usck
出水	vczs
百货	tfil
遗憾的	cyu
大餐	ddix
抽中	jeov
存放	gitw
豆浆	toqb
同样是	ngf
宣告	atkg
四点	zait
里头	hlot
医务人员	jwio
伤痕	iefk
谁不	uymb
有数	gkkx
服务质量	kwzf
切割	lmao
波黑	vgdh
有影响	gfo
歌舞	jjeb
屋面	rttc
国家队	zap
提名	jfbo
局限性	rpy
看中	jmov
丰厚	kfzf
主教练	pes
昂贵	fpcg
上交	itpr
过错	jrla
合唱	aoof
惬意	yjwf
天时	tdfj
下课	oxuf
肺部	ktwo
在哪儿	goa
南海	xqve
丝袜	sspq
傻子	iuiz
盼望	mmpk
官僚	auid
上架	itwg
变迁	rxar
赤裸	hrpf
气死	aqbl
短线	etst
分层	mfra
不懂得	myd
深思	vanc
更应	xfrz
流动性	vay
白白	ubub
梗塞	gxau
天冷	tdei
慢慢的	yyu
满怀	vhym
当了	ebdj
正中	trov
我猜	jlql
前不久	qmm
那次	lpef
预料	sxkk
递给	kcsa
随身	pgps
莫过	imjr
难道是	xqf
网球	nxez
礼仪	diiu
橄榄	gdgn
重申	ahfv
除此	pvrl
凶手	xzjs
次日	effr
死后	blko
生活质量	cvzf
出名	vcbo
运算	arnm
从严	iioc
请他	uliu
中医学	ojz
支部	yxwo
药店	hsri
光学	etzi
基质	mhzy
要什么	dic
浓缩	vbsa
定价	atii
很远	dkjr
行不	dlmb
下功夫	ovy
既能	kivk
进程中	umo
民生	elcm
一站	tywi
打扫	jxjb
探究	jaak
玩儿	ejae
姐妹们	xxi
下调	oxun
来之	qkgz
股指	kojl
眼眶	mkmj
海边	vesr
想吐	gmoh
避孕	rwli
仲裁	ioyl
星期天	fmt
国际竞争	zpwm
猥琐	qnee
滤波	vqvg
复杂性	eky
阻挡	pgje
傻了	iudj
精选	klqa
审视	afdu
不由自主	mecp
两千	zlaq
说对	ukxj
悲观	bcxu
人与人	isi
受教育	eep
奇特	djqh
农民工	bev
大米	ddkm
牛皮	qngp
有希望	gxp
呵护	ojjq
领会	isia
料理	kkeh
集约	ygss
休克	igpa
情趣	ylrb
牡丹	qhnp
天津市	tvp
将从	qbii
兴致	zmth
且不	gqmb
这只是	wof
助手	gsjs
胸怀	ksym
一想到	tgt
花开	hith
思潮	ncvy
猜猜	qlql
囊肿	yoko
待在	dhgh
回落	zopw
它将	alqb
阻塞	pgau
大明星	dff
做为	ipes
拆除	jdpv
放射性	tpy
之美	gzmd
大放	ddtw
人头	irot
制服	qnkp
又道	xyqc
合力	aosl
圣人	xhir
又为	xyes
丸子	kuiz
惊醒	yxdf
红豆	svto
八年	mbev
做错	ipla
点心	itcx
姊姊	xcxc
古今	pgid
不予	mbsx
非常重要的	bzau
泪流	vmvp
复方	eftf
买东西	dyd
外经	bisb
我们一定	jita
为使	esix
比值	lbiy
意料	wfkk
胡说	pkuk
来接	qkjw
不配	mbde
闭幕	njib
出任	vcis
爱美	egmd
拉动	jwas
发展方向	nrtu
这么一个	wcti
金华	sjil
由你	eyim
一般情况	tbye
偏低	iqip
废话	rnua
靴子	ciiz
申花	fvhi
我曾经	jks
会引起	icr
经济全球化	svsi
海绵	vesu
猛地	qihu
惊奇	yxdj
亦是	ryft
急诊	mbui
创造力	jks
系统工程	csvm
中专	ovwv
光照	etfm
终极	swgl
保密	ioac
亿元	igjy
不正常	mtz
赞助	qqgs
终于可以	shjb
了结	djsk
想办法	gsv
也去	uyhv
地段	hudo
急急	mbmb
下滑	oxvy
朦胧	kxkg
一经	tysb
有缘	gkso
强行	codl
非公有制	bmgq
一季	tymi
推迟	jyar
置换	cyjm
路段	bwdo
面目	tcmm
卖了	yddj
共计	amuy
均未	hsqw
望去	pkhv
下水	oxzs
星巴克	fvp
可口	jkok
只用	omjy
不希望	mxp
航线	bpst
一倍	tyiw
看吧	jmov
脚踏	khbz
山寨	wsau
好快	xiyt
风流	nfvp
五四	cwza
悠久	iwmu
树上	gxit
完全没有	asvg
首饰	qcme
不自觉	mcz
小红	vxsv
无非	hibf
也不可能	umjv
对接	xjjw
甜甜	ahah
只要是	odf
阻尼	pgrl
反击	zxhz
巨额	jraw
买房	doqt
睁开眼	mtm
重型	ahta
搞到	jxth
小火	vxwh
身为	pses
票据	dnjr
大半夜	dcp
加快发展	wynr
三条	cswg
调查结果	ugsf
退化	kril
景色	fxmv
上空	itav
领导者	iee
慕容	ivaw
光纤	etsa
瘫痪	fxfm
糖果	krfg
没把	vojv
中央银行	otld
你将	imqb
是什么意思	ficn
其中一个	moti
洽谈	vauw
代码	mdtz
上好	itxi
新西兰	ndq
感悟	ltyc
果真	fgyg
常年	zbev
得失	dfes
庞大的	rdu
下旬	oxsf
皮鞋	gpcb
寒风	aunf
旧的	vfus
打败	jxdw
身分	psmf
剥离	bzwz
不习惯	mey
明了	fkdj
回转	zoyw
发挥作用	njij
导航	ejbp
用在	jygh
丰富多彩	kabe
没回	vozo
强有力的	cgsu
过不去	jmh
擅长	jpyc
朝廷	yysr
终生	swcm
惨了	yvdj
有形	gkth
广义	rgux
弱爆	cewf
必然会	cbi
着眼于	mmh
路况	bweo
观光	xuet
任职	isbo
失效	espr
超前	rmqx
全文	sqww
主要包括	pdsj
党的领导	zuie
直流	ygvp
独家	qcaq
没有办法	vgsv
有针对性	glxy
脸蛋	kadr
大眼睛	dmm
种情况	mye
钓鱼	lsry
经济社会发展	svdr
眼圈	mkzn
余额	vyaw
人流	irvp
炸弹	wkck
名叫	booy
排骨	jbyg
使者	ixez
外星	bifc
五星	cwfc
直升	ygch
耐受	tiex
少吃	msoe
来往	qkdp
迷惑	krlo
出让	vcui
加紧	wjax
你认为	iue
国家机关	zagk
素养	msmu
很痛	dkfs
阵容	pyaw
文体	wwig
点开	itth
脑血管	kcn
大军	dday
另外一个	kbti
学业	zioy
都有一个	egti
相似的	giu
小平	vxhk
爬起来	rrq
譬如	rwxo
伊斯兰	imq
三方	cstf
之外的	gbu
小心翼翼	vcbb
资本市场	egph
历史文化	zowi
怎么知道	kceq
大清	ddvl
厂房	zcqt
敲门	xinm
跳下	beox
上表	itmq
我们说	jiu
旗舰	tmbu
受欢迎	exp
大王	ddew
微型	fnta
无偿	hiie
流感	vplt
透了	mldj
为公	esmv
虽是	osft
背心	klcx
示威	nslt
二哥	wejj
比喻	lboa
绿茶	sbhi
缴纳	susk
最主要的	fpdu
做些	iprl
干警	hghw
理所当然	ezeb
可比	jklb
宝马	aezm
说些	ukrl
切换	lmjm
大同	ddnt
略有	nwgk
梅花	gehi
艺人	hgir
触摸	mjji
后备	kown
竟然是	obf
信息产业	icwo
栓塞	gsau
就可以了	xjbd
美德	mddy
和气	moaq
看不清	jmv
合理性	aey
王朝	ewyy
而为	ties
这些都是	wref
工夫	vgyf
侧重	idah
救济	zuvw
沮丧	vgyq
爷们	rpin
当即	ebkp
一路上	tbi
自来水	cqz
有这个	gwi
选定	qaat
几张	njcy
不必要	mcd
我们都是	jief
自拍	cmju
反过来	zjq
着实	mmao
下场	oxhl
违章	wpoz
吃亏	oewv
涉嫌	vrxq
奶牛	xlqn
也不用	umj
剧场	rphl
山地	wshu
特长	qhyc
看重	jmah
到目前为止	tmqr
正月	trky
研究者	tae
大黄	ddae
创造条件	jkwi
有什么好	gicx
改编	ewsq
通车	sjyc
变质	rxzy
家有	aqgk
仇恨	ikyk
闻名	nbbo
典礼	nadi
新开	ndth
重任	ahis
信用社	ijd
又没有	xvg
有别	gkka
年华	evil
进城	urhl
懂事	yhjo
餐饮	ixmf
财政收入	dtyc
有点儿	gia
大雪	ddzb
肉瘤	kifp
来给	qksa
一新	tynd
残余	btvy
一滴	tyvn
隐形	pmth
风貌	nfqu
个儿	ivae
品位	ooiw
真的假的	yuiu
作用于	ijh
嘉宾	kqad
泛滥	vcvn
几条	njwg
镇江	lyvv
组委	sgmx
转眼	ywmk
男装	nsqh
二逼	wepr
精神上	kdi
柔和	sxmo
饱了	msdj
路由	bwey
腹膜	keki
再发	ennf
总能	kovk
笼罩	ngci
不光	mbet
延迟	crar
美国政府	mztr
杰克	gtpa
进军	uray
贴心	dicx
深入开展	vctr
上任	itis
实质性	azy
抗癌	jpfo
半场	cbhl
卫生间	pcn
才可以	jjb
就因	xvzd
救了	zudj
时分	fjmf
腰部	kdwo
肤色	kymv
最基本的	fmgu
无菌	hihz
室温	atvf
紧密结合	aasa
旅途	tcvr
艾特	hxqh
阐明	nkfk
已久	eymu
多远	bbjr
一端	tyww
又怎么	xkc
一怔	tyyt
规程	yumo
路易	bwfs
血脂	cikl
之初	gzpm
亲友	nqgx
到此	thrl
双侧	xxid
电解	fimj
各种各样的	wmwu
更难	xfxy
胸膛	kskz
饼干	mqhg
激起	vure
坐等	iinh
电位	fiiw
也让	uyui
字幕	aiib
切成	lmle
本来就是	gqxf
石灰	tsgw
党委书记	zmdu
迷信	kriu
某些人	hri
退了	krdj
疏松	drgm
静态	lmdu
困了	zgdj
血液循环	cvde
暑假	feir
色素	mvms
亲属	nqrc
滑坡	vyhg
吸血	olci
此项	rlvt
理论研究	euta
还有很多	mgdb
贱人	dtir
石墨	tsdh
呻吟	ofoi
用过	jyjr
少有	msgk
倒计	ituy
质地	zyhu
没有必要	vgcd
抱抱	jsjs
脏器	kroo
征集	dtyg
浓郁	vbgk
老者	elez
技术开发	jgtn
民意	elwf
抚摸	jhji
实名	aobo
历代	zsmd
礼服	dikp
越过	rljr
高明	xgfk
工人阶级	vips
营运	xoar
没有想到	vggt
认得	uidf
反响	zxou
则在	dagh
思维方式	nstl
翡翠	bbbp
虚弱	qoce
签证	naut
改成	ewle
一如既往	txkd
没啥	vooa
也许会	uui
室外	atbi
还把	mrjv
方位	tfiw
骗人	zqir
公有制经济	mgqv
此种	rlmo
不仅有	mig
胶粘	kpki
运营商	axn
拖欠	jefq
被认为是	puef
不含	mbid
粘附	kipi
东东	yvyv
丹参	npvd
刹那	xglp
弹簧	ckna
看病	jmft
矿山	trws
主干	pzhg
刷新	rbnd
冶金	evsj
初三	pmcs
敬请	houl
所造	zrkr
苦恼	hpyw
立案	wlyg
莫过于	ijh
诈骗	ukzq
抗洪	jpva
除外	pvbi
喝道	ofqc
手气	jsaq
半身	cbps
一成	tyle
王道	ewqc
建构	bhgs
麦克	mwpa
湿润	vfvn
可悲	jkbc
与日	syfr
仍旧	ilvf
有分	gkmf
英勇	htsj
也罢	uych
服务中心	kwoc
实际问题	apnf
造林	kryl
为基础的	emtu
盗窃	efal
对我来说	xjqu
周二	nhwe
丹麦	npmw
咬牙	optx
仅此	ixrl
打招呼	jjo
水肿	zsko
跳起	bere
归属	abrc
吃药	oehs
课外	ufbi
乐意	pvwf
僵硬	ittx
写真	asyg
培养基	hmm
刷牙	rbtx
施肥	tukv
可他	jkiu
专职	wvbo
供求	iazu
弱爆了	cwd
有责	gkmd
咽喉	ozor
而要	tidx
基督教	mie
极力	glsl
一则	tyda
过量	jrft
浙江大学	vvdz
职称	bomm
坐下来	ioq
热气	ptaq
哪种	olmo
洗完	vqaj
歹徒	bddr
大企业	dio
搞了	jxdj
说的好	uux
围着	zwmm
一个地方	tiht
却说	hvuk
难道不	xqm
痛了	fsdj
要强	dxco
条纹	wgsw
花样	higm
玩过	ejjr
皮带	gpma
预见	sxuj
自古	cmpg
间断	nfki
誓言	jduy
哈佛	oaic
通俗	sjiw
酒后	vdko
总公司	kme
一有	tygk
这批	wrjl
可能就	jvx
中西医	odj
冷淡	eivw
暂行	yddl
精细	klsn
想打	gmjx
倒计时	iuf
普通人	qsi
所引	zrcv
坚定不移	aamm
求助	zugs
方法论	tvu
销魂	leau
电泳	fivu
大名	ddbo
降雨	pwzy
闪光	niet
个性化	iyi
邪教	txei
沧桑	vjxx
油画	vetn
多的是	buf
工作量	vif
终结	swsk
科学性	mzy
农家	bqaq
淘金	vssj
更美	xfmd
犯罪分子	qcmi
具体情况	giye
不锈钢	mll
在那个	gli
粘结	kisk
简易	nnfs
保管	iona
经济活动	svva
海湾	vevr
选出	qavc
耐磨	tiry
算什么	nic
无从	hiii
平均值	hhi
出面	vctc
转运	ywar
巴掌	vbzj
国营	zexo
原是	zuft
了下去	doh
亲王	nqew
性情	ycyl
深圳市	vhp
自然是	cbf
可贵	jkcg
超人	rmir
增长了	hyd
卖出	ydvc
菩萨	hwhp
迈出	tevc
饱满	msvh
部落	wopw
很严	dkoc
新城	ndhl
大汉	ddvx
小宝	vxae
于此	hyrl
夜空	piav
手势	jsps
顽固	jtzp
粤语	ukuc
诉说	uduk
铁道部	lqw
恰好	yaxi
刀具	mdgm
把关	jvkd
二期	wemk
背部	klwo
同你	ntim
能干	vkhg
好比	xilb
轻轻的	yyu
长篇	ycnq
方舟	tfbz
自已	cmey
深切	valm
呼声	ocrs
樱桃	gdge
窗帘	auab
隐瞒	pmmh
没有那么	vglc
表哥	mqjj
还不知道	mmeq
粘液	kivp
美观	mdxu
大口	ddok
言行	uydl
总在	kogh
液晶	vpff
坚守	axaj
今天早上	itfi
工程学	vmz
眼皮	mkgp
飞船	gebn
卡车	ioyc
假定	irat
执业	pzoy
别想	kagm
散装	akqh
疲倦	fgin
大惊	ddyx
陈奕迅	prg
金字	sjai
三分之一	cmgt
难道我	xqj
国力	zesl
切实加强	lawc
万达	tedr
生产资料	cwek
单调	kfun
历经	zssb
移位	mbiw
贵阳	cgpf
这样才能	wgjv
射击	pjhz
意向	wfuo
三等	csnh
叹了口气	odoa
事务所	jwz
免疫力	mfs
上火	itwh
风度	nfrh
学费	zica
海尔	vemv
睡神	madf
通货膨胀	sikk
沉降	vapw
各单位	wki
旅行社	tdd
几步	njrm
久久	mumu
又是一个	xfti
收听	ywod
此举	rlzm
缺口	qtok
定点	atit
购置	dscy
绽放	satw
职场	bohl
阶级斗争	pskm
有礼	gkdi
有一位	gti
使它	ixal
情怀	ylym
路径	bwdb
静静的	llu
现阶段	epd
想到的	gtu
老外	elbi
为目的	emu
迟疑	arle
最後	fbds
哪一个	oti
还是个	mfi
目睹	mmme
有线	gkst
阿里	pjhl
承办	dzsm
南平	xqhk
流行病	vdf
有幸	gkhq
本质上	gzi
汕头	vwot
准备好了	ewxd
找人	jlir
脱贫	kkmd
思想道德	ngqd
市场价	phi
布莱	gbhq
蛋疼	drfw
起飞	rege
各族人民	wtie
请教	ulei
磁场	tqhl
跨世纪	bus
表现得	med
尽在	aegh
文化建设	wibu
地球上	hei
姥姥	xexe
仰望	ippk
暂停	ydix
封锁	bjle
来抓	qkjr
她觉得	xzd
契约	kmss
点到	itth
伤人	ieir
顶级	xtsl
暗中	fwov
花卉	hiyh
贿赂	dgdw
比利时	lmf
侵袭	ibgp
纯真	slyg
走出来	rvq
改名	ewbo
洋葱	vmhs
双目	xxmm
加压	wjzh
借款	iahn
舒张	apcy
中来	ovqk
转入	ywcu
充当	paeb
太难	duxy
没有得到	vgdt
高价	xgii
个子	iviz
不知道为什么	meqc
尚无	eshi
海内外	vkb
一系列的	tcbu
隐私	pmmv
看出来	jvq
社会生产	dicw
肉鸡	kixe
明媚	fkxr
拉拉	jwjw
出具	vcgm
慷慨	yryk
碳酸	twdv
交界	prni
严禁	ocyn
陕西省	pdm
盐酸	hidv
忍心	mucx
新闻发布	nnng
月来	kyqk
妈呀	xzot
完备	ajwn
聆听	biod
保罗	iocb
挣钱	jmlt
热潮	ptvy
五月天	ckt
断面	kitc
大多是	dbf
喝醉	ofdp
安宁	yaan
金正日	stf
坦克	hfpa
米饭	kmmz
看不懂	jmy
中青	ovlq
民俗	eliw
四分	zamf
玩得	ejdf
世界各地	unwh
妇科	xbmk
货车	ilyc
监督检查	aigg
中央军委	otam
危险性	mpy
喊道	olqc
何等	ijnh
同性恋	nyr
不跟	mbbk
声中	rsov
就使	xvix
调试	unul
成败	ledw
对啊	xjop
两周	zlnh
误区	uojx
检察机关	gagk
巡逻	srcb
你愿意	izw
可疑	jkle
堪称	hmmm
流体	vpig
几乎没有	ncvg
瞎了	madj
散热	akpt
入选	cuqa
有效性	gpy
超大	rmdd
打到	jxth
往外	dpbi
及格	ljgw
蒋介石	hit
尿道	rzqc
更何况	xie
上楼	itgk
可取	jkbx
又不能	xmv
数字化	kai
平整	hkgw
特区	qhjx
深感	valt
输液	yavp
条线	wgst
相邻	gmis
铅笔	lnnq
舅舅	unun
环球	emez
多半	bbcb
摸摸	jiji
清澈	vlvp
擦肩	jaqk
悲惨	bcyv
制药	qnhs
赛场	auhl
总管	kona
汇总	vjko
一直没有	tyvg
不法	mbvh
上身	itps
务必	wscc
上当	iteb
股份有限公司	kige
凌乱	ehai
值得注意	idvw
走过来	rjq
烧结	wlsk
普京	qoxv
双脚	xxkh
气愤	aqyy
之功	gzvs
无限的	hpu
加水	wjzs
方针政策	tltn
走出去	rvh
元年	jyev
节课	hpuf
不耐烦	mtw
好学	xizi
芙蓉	hypw
一文	tyww
非常的	bzu
往往会	ddi
广大群众	rdbi
日军	fray
盒子	aoiz
明珠	fkeq
你妹啊	ixo
子系统	ics
真皮	yggp
弱者	ceez
脾胃	kunk
假日	irfr
准备工作	ewvi
瞄准	mhey
锅炉	lowq
一些问题	trnf
矫正	ectr
充分认识	pmuu
自强	cmco
分别在	mkg
法律规定	vdya
三军	csay
中国特色社会主义	ozqu
国内市场	zkph
词语	ueuc
付款	ijhn
理发	ehnf
悬挂	gvjb
这等	wrnh
峰值	wwiy
中级	ovsl
午夜	qwpi
只需要	ozd
一斤	tydj
轮胎	yikv
子弟	izkc
当晚	ebfm
省内	mmkn
照亮	fmxn
高强	xgco
证件	utiq
生前	cmqx
谦虚	uqqo
研究室	taa
英寸	htjc
轰炸	yxwk
圈子	zniz
非凡	bfnu
编者	sqez
乐队	pvpi
工作报告	vijk
再到	enth
杀害	xgak
和好	moxi
空腹	avke
不仅在	mig
一曲	tyfa
跑来	bsqk
奶粉	xlkm
余地	vyhu
奢华	deil
骆驼	zwza
幸福生活	hdcv
小声	vxrs
怒火	xxwh
城堡	hlio
你爸	imrv
流速	vpgo
亲吻	nqos
这段时间	wdfn
谁要	uydx
体育课	ipu
年代末	emq
江西省	vdm
争吵	mbom
道出	qcvc
北海	klve
但同	ifnt
昨夜	fkpi
东盟	yvfk
已将	eyqb
全集	sqyg
产妇	wcxb
高人	xgir
前线	qxst
未免	qwmo
决不能	emv
何不	ijmb
海域	vehl
帮主	kppz
哲学家	jza
酝酿	dadu
国旗	zetm
被判	pgca
一包	tysb
吵醒	omdf
排行榜	jdg
脱光	kket
必然要	cbd
后半	kocb
辛勤	wxhm
领悟	isyc
刚看	nxjm
怪物	yxqs
雄厚	gvzf
基准	mhey
改正	ewtr
原告	zukg
刘少奇	wmd
纯净	slem
对那些	xlr
一盘	tybi
鼓掌	kqzj
有余	gkvy
预先	sxqa
去见	hvuj
关门	kdnm
坐车	iiyc
点名	itbo
长官	ycau
不是什么	mfic
转头	ywot
违法行为	wvde
对事	xjjo
军医	ayje
电针	fily
研究人员	taio
想象力	ges
心碎	cxtp
咳咳	osos
爱死	egbl
同心	ntcx
陈述	pygu
什么也没	icuv
兽医	knje
回过头	zjo
流逝	vpjd
难于	xyhy
沉浸	vavb
乱收费	ayc
一般是	tbf
特权	qhgx
先进技术	qujg
污染物	vvq
拉住	jwip
科技创新	mjjn
求你	zuim
女同	xnnt
没时间	vfn
红外	svbi
证券市场	unph
访谈	utuw
物种	qsmo
特殊性	qby
打过	jxjr
就地	xvhu
登场	bthl
护照	jqfm
家禽	aqiw
站起身	wrp
台词	voue
口语	okuc
以至于	bth
工作上	vii
滑雪	vyzb
兑现	koeu
知名度	ebr
国务院副总理	zwpe
分担	mfjf
好些	xirl
埋怨	hhbe
辩证法	wuv
在座	ghri
角膜	mjki
普遍的	qqu
日渐	frvy
畅销	fvle
想必	gmcc
跌倒	beit
不正之风	mtgn
也非	uybf
指的是	juf
厌倦	zdin
晴天	fltd
担当	jfeb
接连	jwyr
项链	vtly
在这时	gwf
试过	uljr
柜台	gjvo
国家标准	zage
基本原则	mgzd
尼克	rlpa
噩梦	eoyb
这东西	wyd
准确性	ety
沐浴	vgvw
分辨率	mwp
现身	eups
需要一个	zdti
不幸的	mhu
珠江	eqvv
无忧	hiyi
技术进步	jgur
听起来	orq
驾驭	wzzx
马列	zmba
苦苦	hphp
回头看	zoj
长剑	ycaz
做作	ipik
面料	tckk
皇冠	ueaj
摧毁	jwuv
总共	koam
跳跃	bebc
参考文献	vewx
名片	botp
她家	xuaq
一词	tyue
书本	dpgt
无理	hieh
游行	vtdl
一年里	teh
不买	mbdo
毛孔	qmii
中下	ovox
燕子	hoiz
发展起来	nrrq
回不去	zmh
京城	xvhl
两端	zlww
也会有	uig
单词	kfue
这年头	weo
成功率	lvp
城管	hlna
优异	iieh
古怪	pgyx
即刻	kpsa
管制	naqn
后续	kosy
横行	gadl
竹林	nzyl
肥料	kvkk
能与	vksy
吃肉	oeki
柯南	gjxq
融化	tnil
刚开始	ntx
诺基亚	umo
那还	lpmr
将你	qbim
求真	zuyg
线上	stit
拖着	jemm
比率	lbps
转折	ywjd
国家重点	zaai
漫步	vfrm
用上	jyit
最能	fbvk
实实在在	aagg
地基	humh
铃声	lirs
爱好者	exe
青年人	lei
静止	lmrz
新高	ndxg
枢纽	gjso
竞选	woqa
一本书	tgd
区间	jxnf
严格执行	ogpd
瓶子	qhiz
波长	vgyc
禁忌	ynec
有此	gkrl
一记	tyue
量子	ftiz
得来	dfqk
并行	qhdl
零部件	zwi
恶意	ocwf
很早	dkfy
正宗	tran
氯化	abil
电网	finx
火热	whpt
专制	wvqn
小屋	vxrt
更需	xfzt
黎明	msfk
涂层	vvra
国内生产总值	zkci
大呼	ddoc
这番	wrck
自觉性	czy
恶魔	ocry
剧院	rppa
知晓	eofl
某某	htht
打好	jxxi
奋战	dnil
影响着	fom
三个方面	citt
怒气	xxaq
因地制宜	zhqa
瀑布	vfgb
有责任	gmi
学派	zivz
出头	vcot
若无	hghi
工程项目	vmvm
价钱	iilt
总有一天	kgtt
实处	aowi
美景	mdfx
积极作用	mgij
日产	frwc
已经没有	esvg
粪便	kaix
阿弥陀佛	pcpi
刻苦	sahp
成为一种	letm
下山	oxws
失控	esja
大发展	dnr
科目	mkmm
不那么	mlc
之家	gzaq
工作效率	vipp
经济合作	svai
已从	eyii
不与	mbsy
潮湿	vyvf
红楼	svgk
绳子	soiz
守候	ajir
美国总统	mzks
早知道	feq
蛮好	rcxi
有法	gkvh
网吧	nxov
洗头	vqot
大哭	ddoo
这部分	wwm
上路	itbw
家家	aqaq
遗留	crpm
则为	daes
罪行	cbdl
着地	mmhu
填补	hypi
过剩	jrmk
车票	ycdn
最适合	faa
并由	qhey
二个	weiv
招牌	jmtu
内裤	knpr
毫升	xqch
贪婪	idyx
几家	njaq
没有过	vgj
远端	jrww
抓获	jrhq
吃着	oemm
游览	vtan
再也没有	euvg
仅是	ixft
住宿	ipai
发展规划	nryl
对症	xjft
供销	iale
逼近	prdr
电容	fiaw
售后	yoko
乙肝	gykh
责任人	mii
厚厚	zfzf
议事	uujo
双层	xxra
反驳	zxzx
比对	lbxj
木瓜	gmrg
中国电信	ozfi
打发	jxnf
经济学家	svza
小哥	vxjj
天子	tdiz
侦察	iiab
上过	itjr
风俗	nfiw
我想到	jgt
课本	ufgt
之分	gzmf
利税	mamk
好说	xiuk
看去	jmhv
谁啊	uyop
等离子	nwi
之王	gzew
企事业	ijo
复旦大学	efdz
眼角	mkmj
民用	eljy
美化	mdil
排气	jbaq
不断扩大	mkjd
纯度	slrh
限定	pkat
挡住	jeip
显瘦	fofu
吞噬	tdon
极高	glxg
焦急	yjmb
素材	msgj
依赖性	igy
餐桌	ixif
放送	twkd
已由	eyey
这一刻	wts
真要	ygdx
喂养	onmu
不快乐	myp
潮人	vyir
狼狈	quqd
下落	oxpw
逃离	eewz
下身	oxps
游击	vthz
脑中	kwov
中选	ovqa
表现出来	mevq
村干部	ghw
水渍	zsvm
贴在	digh
起草	rehf
不一致	mtt
格子	gwiz
好点	xiit
好烦	xiwt
镇定	lyat
睡懒觉	myz
挺好的	jxu
后在	kogh
日月	frky
别有	kagk
必要性	cdy
十二指肠	ywjk
他们认为	iiue
过着	jrmm
千瓦	aqfw
不争	mbmb
加固	wjzp
为数	eskx
泸州	visz
友人	gxir
睡到自然醒	mtcd
听完	odaj
满面	vhtc
不提	mbjf
了事	djjo
十余	ysvy
送出	kdvc
建起	bhre
初级阶段	pspd
反革命	zca
高雅	xgtx
有神	gkdf
减退	elkr
微弱	fnce
靠着	kbmm
华南	ilxq
有位	gkiw
公报	mvjp
早稻	fyme
单机	kfgn
精明	klfk
每一位	eti
从政	iitr
一次次	tee
业内人士	okih
情愿	ylzu
更容易	xaf
确定性	tay
对口	xjok
评判	uhca
声誉	rszm
腹水	kezs
血红	cisv
布鲁	gbrf
稍有	megk
骨骼	ygyw
县政府	gtr
盐水	hizs
琢磨	eqry
全村	sqgj
门户	nmqh
小品	vxoo
源泉	vzuz
丛书	iidp
烈士	bahs
仆人	iiir
前世	qxus
挽救	jmzu
管理模式	negl
教科书	emd
即日	kpfr
单曲	kffa
唐代	rbmd
开朗	thuk
我不敢	jmd
白雪	ubzb
已达到	edt
二楼	wegk
关节炎	khw
航道	bpqc
亲身	nqps
上世	itus
病了	ftdj
刑罚	thcu
马拉	zmjw
如果一个	xfti
明早	fkfy
刑事诉讼	tjuu
用人单位	jiki
去掉	hvji
世界末日	unqf
阵阵	pypy
就拿	xvao
或在	logh
有保	gkio
山顶	wsxt
老朋友	ekg
挥手	jajs
市级	pbsl
亲和	nqmo
明信	fkiu
霸道	zcqc
张杰	cygt
该做	usip
参见	vduj
公证	mvut
我也不知道	jumq
吓到	ooth
换上	jmit
渔民	vrel
合约	aoss
占比	izlb
但就	ifxv
我是一个	jfti
百花	tfhi
不比	mblb
艺术品	hgo
能对	vkxj
专业知识	woeu
多喝	bbof
饥饿	mnmj
三层	csra
投向	jouo
名列	boba
组委会	smi
在怀	ghym
自恋	cmrc
事实证明	jauf
各个方面	witt
挪用	jljy
新成	ndle
两个人的	ziiu
长征	ycdt
贵宾	cgad
而行	tidl
发财	nfdj
思想工作	ngvi
发脾气	nka
决定性	eay
优越性	iry
肿么办	kcs
每隔	eopt
药材	hsgj
明信片	fit
但可	ifjk
一把手	tjj
小王	vxew
龙岩	glwt
拖延	jecr
喇叭	ogom
耽误	bbuo
壮观	qhxu
所造成	zkl
多于	bbhy
恨不得	ymd
预约	sxss
跨国公司	bzme
买菜	dohe
习俗	exiw
写成	asle
中央电视台	otfv
新闻发布会	nnni
长老	ycel
衍生	dvcm
非得	bfdf
就可能	xjv
绝不能	smv
贮存	dagi
现实中	eao
但没有	ivg
有信心	gic
兼容	qbaw
紧接	axjw
对数	xjkx
逍遥	ekeq
读过	uyjr
克制	paqn
金银	sjlk
三部	cswo
各个领域	wiih
海贼	vedl
便有	ixgk
惊心	yxcx
流畅	vpfv
宏观经济	axsv
吃醋	oeda
厚的	zfus
花心	hicx
随心	pgcx
不仅可以	mijb
太后	duko
金融危机	stmg
确有	tmgk
跟前	bkqx
分钱	mflt
还用	mrjy
洗涤	vqvw
闪亮	nixn
构思	gsnc
信托	iujc
直视	ygdu
毛线	qmst
剖析	wogd
装扮	qhjm
喝多	ofbb
昼夜	afpi
大关	ddkd
时节	fjhp
极不	glmb
山庄	wsrh
色谱	mvuq
陷阱	pmpu
吃苦	oehp
会后	iako
坐到	iith
统计分析	sumg
寄托	adjc
结尾	skrq
无机	hign
诚意	ulwf
呆呆	ogog
还被	mrpg
共同发展	annr
怪异	yxeh
做工	ipvg
太累	duns
涨价	vcii
大蒜	ddhn
浪潮	vuvy
世界和平	unmh
悄悄地	yyh
分管	mfna
投降	jopw
施展	tura
富贵	apcg
仍未	ilqw
说吧	ukov
复活	efva
挪威	jllt
大树	ddgx
还有一些	mgtr
一波	tyvg
哪位	oliw
乌克兰	epq
所指	zrjl
料到	kkth
暖气	feaq
之意	gzwf
溶剂	vawa
也同样	ung
都未	epqw
抵御	jpde
服了	kpdj
这一个	wti
像素	iems
沿线	vnst
元首	jyqc
管内	nakn
演化	vail
现任	euis
火山	whws
两面	zltc
有偿	gkie
王府	ewri
应从	rzii
方差	tfmv
吃出	oevc
幸亏	hqwv
徐州	dvsz
代言	mduy
为了你	edi
发展生产	nrcw
大图	ddzw
烦死	wtbl
物力	qssl
行车	dlyc
小男孩	vni
凄凉	eyex
探查	jagf
顾虑	zeqc
定为	ates
泰山	uzws
未完	qwaj
有些事情	grjy
内力	knsl
常说	zbuk
杂质	kgzy
买来	doqk
我还以为	jmbe
越发	rlnf
是故	ftpw
这个样子	wigi
不透	mbml
生于	cmhy
盛大	ledd
水里	zshl
拨款	jnhn
飘过	dnjr
一侧	tyid
二字	weai
呼叫	ocoy
压痛	zhfs
球场	ezhl
小猫	vxqh
发来	nfqk
太守	duaj
白发	ubnf
寄生虫	acc
当归	ebab
机型	gnta
疼爱	fweg
康熙	rbje
并于	qhhy
研究对象	taxe
冻死	eybl
修饰	iwme
辖区	yajx
区县	jxgv
参展	vdra
显微镜	ffl
财物	djqs
硬是	txft
着火	mmwh
要不然	dmb
按钮	jylo
直接关系	yjkc
志趣	hcrb
只眼	ommk
指点	jlit
保定	ioat
一粒	tykw
送去	kdhv
跳动	beas
都让	epui
好奇心	xdc
中国国际	ozzp
正视	trdu
心力	cxsl
反倒	zxit
老总	elko
留住	pmip
泄漏	vuvr
打来	jxqk
运行机制	adgq
廉价	rqii
鱼肉	ryki
细小	snvx
经济区	svj
受人	exir
搬迁	jbar
农副	bqpa
乡亲	scnq
最怕	fbyu
大本	ddgt
多做	bbip
兴办	zmsm
职员	bood
搞活	jxva
回馈	zomc
流下	vpox
实测	aovd
很多事情	dbjy
他希望	ixp
全天	sqtd
地平	huhk
中科院	omp
充血	paci
实质上	azi
衰退	pokr
年级	evsl
感知	lteo
补水	pizs
必不可少	cmjm
供应商	irn
有异	gkeh
农历	bqzs
咬着	opmm
太阳能	dpv
吸入	olcu
火车站	wyw
最简	fbnn
声称	rsmm
至上	tvit
文艺青年	whle
不轻	mbyb
先到	qath
羽毛球	bqe
走好	rzxi
极易	glfs
列出	bavc
每每	eoeo
旗下	tmox
完好	ajxi
沉着	vamm
厂里	zchl
生姜	cmmx
校正	gptr
小便	vxix
之久	gzmu
省长	mmyc
寿司	kjet
请客	ulaw
旅游资源	tvev
解毒	mjmo
任何时候	iifi
吉林省	kym
已于	eyhy
再想	engm
主要表现在	pdmg
深层次	vre
诧异	uaeh
海口	veok
光盘	etbi
多出	bbvc
非典型	bnt
上街	itdb
扬起	jlre
揭开	jfth
使用寿命	ijka
国道	zeqc
及早	ljfy
我们没有	jivg
宛如	abxo
北美	klmd
剥削	bzek
升温	chvf
无可奈何	hjdi
瓶颈	qhbv
预感	sxlt
致癌	thfo
可说	jkuk
全然	sqbu
老挝	eljj
天大	tddd
常数	zbkx
癫痫	fyfn
国际贸易	zppf
身价	psii
说明书	ufd
挂牌	jbtu
撒娇	jaxc
专卖	wvyd
男主角	npm
两个小时	zivf
树叶	gxoy
抗震	jpzz
请您	ulim
投身	jops
现代社会	emdi
审定	afat
叫声	oyrs
鞭炮	ciws
生产者	cwe
爵士	ekhs
色泽	mvvx
副委员长	pmoy
李岚清	gwv
只求	omzu
也是这样	ufwg
企业文化	iowi
死心	blcx
丽江	tnvv
总监	koan
就以	xvby
构件	gsiq
奥林匹克	uyjp
耸肩	iiqk
镇静	lylm
共青	amlq
广大人民群众	rdii
中标	ovgn
合计	aouy
也是个	ufi
嘎嘎	otot
报仇	jpik
下令	oxis
不胜	mbkc
被害	pgak
拿去	aohv
几句话	nsu
惯性	yoyc
有期	gkmk
经商	sbns
与众不同	simn
门槛	nmgn
望了	pkdj
阴极	pkgl
病理学	fez
山坡	wshg
聚合物	baq
果实	fgao
万元	tejy
哭着	oomm
勤劳	hmxs
讲到	uuth
野蛮	hsrc
有啥	gkoa
郑重	kdah
印花	pphi
初次	pmef
中国市场	ozph
下乡	oxsc
英格兰	hgq
听众	odii
兴国	zmze
国家主席	zapr
厦门市	znp
膳食	kmfs
居委	rpmx
预警	sxhw
党和人民	zmie
葫芦	hphq
河水	vjzs
置身	cyps
改建	ewbh
社会环境	dieh
肝功	khvs
完全不同	asmn
整个社会	gidi
试卷	ulne
淡化	vwil
甘草	hthf
绅士	sfhs
看到一个	jtti
附着	pimm
突破口	ato
不畅	mbfv
建立一个	bwti
相等	gmnh
于心	hycx
脱位	kkiw
帝王	wbew
通气	sjaq
满天	vhtd
不赖	mbgo
最小的	fvu
风味	nfoq
迷恋	krrc
平均水平	hhzh
公孙	mviv
登山	btws
是一样的	ftgu
赌博	deyj
这些话	wru
品格	oogw
大牌	ddtu
螺钉	cnlx
大妈	ddxz
司徒	etdr
上位	itiw
取胜	bxkc
透视	mldu
面粉	tckm
那么多的	lcbu
你也是	iuf
重伤	ahie
停车场	iyh
上场	ithl
心烦	cxwt
影院	fvpa
解析	mjgd
申领	fvis
飞翔	gemb
引人注目	civm
看透	jmml
什么关系	ickc
有灵	gkbw
亚运	oyar
药师	hsat
伸出手	ivj
人称	irmm
不限	mbpk
曾是	kvft
巨人	jrir
集会	ygia
教职	eibo
语录	ucbz
养蜂	mucw
专属	wvrc
功课	vsuf
鲜艳	rmkm
那个时候	lifi
一串	tyoo
手足	jsbz
卖家	ydaq
奢望	depk
越来越高	rqrx
励志	zthc
卡尔	iomv
飞快	geyt
隶属	bzrc
蝙蝠	cqcp
下辈	oxby
钢材	lngj
认清	uivl
汽油	vave
冷战	eiil
邮电	epfi
不乏	mbcg
精子	kliz
蚂蚁	czcu
不足以	mbb
起义	reux
可由	jkey
脱口	kkok
华夏	iltm
光合	etao
撞击	jwhz
教主	eipz
葡萄牙	hht
底层	rpra
调戏	unxl
十一届三中全会	ytri
西方国家	dtza
交付	prij
肿么了	kcd
惊叹	yxox
心房	cxqt
半个小时	civf
大中型企业	doto
行长	dlyc
依赖于	igh
好梦	xiyb
精辟	klro
需求量	zzf
被誉为	pze
告诫	kgul
倔强	irco
漆黑	vgdh
市场机制	phgq
睡过	majr
停电	ixfi
评比	uhlb
对日	xjfr
我的天	jut
折扣	jdjo
凭着	ismm
降压	pwzh
遇难	nnxy
堵车	heyc
赶回	rhzo
有本事	ggj
很奇怪	ddy
估算	ipnm
莲花	hyhi
忘不了	pmd
阶段性	pdy
空洞	avvn
离家	wzaq
参谋	vduh
行之有效	dggp
雕刻	nhsa
手心	jscx
类别	kdka
有失	gkes
纳税人	smi
大业	ddoy
绑架	skwg
耀眼	eamk
坦白	hfub
理顺	ehst
按下	jyox
冰雪	ezzb
图纸	zwsp
轮回	yizo
画画	tntn
田园	ntzj
极致	glth
萨达姆	hdx
十多年	ybe
珍藏	eihl
盆腔	mika
等高	nhxg
乱世	aius
下辈子	obi
光谱	etuq
另一个人	ktii
大多数人	dbki
套管	ddna
顺手	stjs
车主	ycpz
正想	trgm
事宜	joag
推翻	jycn
大功	ddvs
绘制	siqn
切身	lmps
不用说	mju
肩负	qkif
建筑面积	bntm
学分	zimf
南瓜	xqrg
王爷	ewrp
实业	aooy
更广	xfrg
打起	jxre
在很大程度上	gddi
宋代	agmd
患有	oogk
益气	qmaq
上马	itzm
出土	vcht
上图	itzw
诺言	uhuy
多情	bbyl
多看	bbjm
不低	mbip
悄然	yebu
中国人民解放军	ozia
青霉素	lzm
定额	ataw
玩吧	ejov
落叶	pwoy
不方便	mti
勾引	svcv
减速	elgo
纽带	soma
拉丁	jwxd
仔猪	iiqe
大成	ddle
心神	cxdf
色调	mvun
外壳	biha
用什么	jic
书包	dpsb
负重	ifah
民法	elvh
乳液	eivp
本期	gtmk
下行	oxdl
掌门人	zni
第一条	ntw
微妙	fnxm
胃肠道	nkq
闭合	njao
倒也	ituy
一例	tyib
神父	dfrf
急救	mbzu
学着	zimm
中立	ovwl
提拔	jfjn
见人	ujir
而没有	tvg
贫下中农	moob
生下	cmox
英俊	htiv
上世纪	ius
全长	sqyc
缅甸	stsn
白领	ubis
微微一笑	fftn
发展阶段	nrpd
花儿	hiae
下部	oxwo
应邀	rzuw
嗓音	oxwf
司法机关	evgk
白糖	ubkr
民国	elze
递增	kchk
面容	tcaw
责任心	mic
灵敏度	ber
求婚	zuxp
熟人	xkir
腰带	kdma
以人为本	bieg
海峡两岸	vwzw
明智	fkeo
抗旱	jpfh
甲醛	njdh
就是一种	xftm
另一半	ktc
新课	nduf
多么的	bcu
发达地区	ndhj
都像	epie
洋溢	vmvq
索尼	yarl
毫无疑问	xhln
明儿	fkae
两块	zlht
动词	asue
闻到	nbth
加减	wjel
请假	ulir
隐蔽	pmhb
获利	hqma
不无	mbhi
极品	gloo
黄土	aeht
一模一样	tgtg
跳了	bedj
召集	mzyg
只说	omuk
周转	nhyw
观音	xuwf
听说过	ouj
坎坷	hfhj
泡泡	vsvs
飞驰	gezu
双双	xxxx
金字塔	sah
造血	krci
想用	gmjy
同济	ntvw
脱下	kkox
有福	gkdp
总和	komo
道德建设	qdbu
白头	ubot
洁净	vkem
新路	ndbw
深入研究	vcta
秀丽	mltn
洒脱	vdkk
趴在	bmgh
绝不是	smf
是那样	flg
你们说	iiu
凤姐	nxxg
先天性	qty
妇联	xbbk
四级	zasl
回路	zobw
现在开始	egtx
即时	kpfj
有价值的	giiu
入党	cuza
应为	rzes
反感	zxlt
松了	gmdj
星光	fcet
挥霍	jazy
兑换	kojm
配送	dekd
善待	mqdh
时髦	fjdq
张纸	cysp
拖鞋	jecb
击中	hzov
是怎么了	fkcd
乱七八糟	almk
聊聊	bpbp
曾经有	ksg
也挺	uyjs
将与	qbsy
清代	vlmd
夹杂	ykkg
楼房	gkqt
小肠	vxkl
短期内	emk
债权人	igi
侵入	ibcu
缓和	semo
写在	asgh
屏障	rqpo
童鞋	whcb
无用	hijy
汇聚	vjbx
是不是有	fmfg
整套	gwdd
全线	sqst
提及	jflj
再把	enjv
地利	huma
风水	nfzs
社会主义精神文明	dipf
褐色	pfmv
这种现象	wmee
你俩	imiz
农科	bqmk
建交	bhpr
有效措施	gpjt
致敬	thho
并要	qhdx
求职	zubo
往年	dpev
科室	mkat
灵活性	bvy
积极开展	mgtr
共青团	alz
低下头	ioo
黑了	dhdj
我可能	jjv
安卓	yaif
香菇	mfhx
丢掉	atji
如水	xozs
灰尘	gwvh
相当大	ged
神经系统	dscs
组团	sgzj
外公	bimv
生效	cmpr
吸纳	olsk
岂不是	wmf
抗击	jphz
卖给	ydsa
核实	gsao
钞票	lmdn
作案	ikyg
拉萨	jwhp
北极	klgl
根本性	ggy
不熟	mbxk
功利	vsma
各家	wgaq
最常见	fzu
示意图	nwz
兰花	qwhi
八百	mbtf
灯火	wxwh
皇家	ueaq
姊妹	xcxq
开开心心	ttcc
毛泽东同志	qvyh
飞速	gego
果汁	fgvy
剪切	qxlm
建筑业	bno
外围	bizw
经济实力	svas
小店	vxri
胃炎	nkww
擦肩而过	jqtj
南斯拉夫	xmjy
泪流满面	vvvt
不知道的	mequ
新任	ndis
现在我们	egji
手枪	jsgj
噪音	oowf
票房	dnqt
小车	vxyc
倡议	ifuu
号称	ovmm
这么大的	wcdu
通话	sjua
里边	hlsr
更需要	xzd
四次	zaef
菜单	hekf
昨天下午	ftoq
中低	ovip
每年的	eeu
天性	tdyc
武夷	tldc
解读	mjuy
倾诉	ilud
肯德基	rdm
较量	ypft
不出去	mvh
配上	deit
一剑	tyaz
研究会	tai
流行病学	vdfz
测得	vddf
所想	zrgm
帮她	kpxu
继而	skti
之力	gzsl
庭院	rspa
柏林	guyl
再没	envo
开奖	thqb
制度化	qri
备战	wnil
竭力	wfsl
喜庆	kqrd
优良传统	iuis
自个	cmiv
迫切需要	ulzd
晋江	ofvv
逃跑	eebs
测算	vdnm
有条件的	gwiu
绿豆	sbto
一刹	tyxg
短发	etnf
网易	nxfs
出个	vciv
突然间	abn
十二星座	ywfr
彩蛋	egdr
金刚石	snt
大洋	ddvm
冷酷	eidk
仅占	ixiz
内在的	kgu
二维	wesy
轻柔	ybsx
案子	ygiz
简直就是	nyxf
高频	xgrm
不必要的	mcdu
海滩	vevx
悠悠	iwiw
告白	kgub
合一	aoty
并重	qhah
肠胃	klnk
江山	vvws
倾销	ille
利尿	marz
显出	fovc
主动性	pay
才叫	jcoy
取消了	bvd
捧着	jumm
绝对不会	sxmi
矿业	troy
因为没有	zevg
方便面	tit
科研成果	mtlf
胫骨	kbyg
一般来说	tbqu
动用	asjy
斯特	mdqh
点起	itre
文化大革命	wida
备受	wnex
专人	wvir
却仍	hvil
容纳	awsk
一不小心	tmvc
切削	lmek
天王	tdew
演示	vans
湿地	vfhu
更具	xfgm
所带来的	zmqu
新股	ndko
生出	cmvc
引来	cvqk
科幻	mkse
世博	usyj
适合于	aah
核查	gsgf
菠菜	pghe
创汇	javj
招收	jmyw
过瘾	jrfp
诺贝尔	udm
命中	aoov
泥土	vrht
特产	qhwc
拨打	jnjx
开场	thhl
外向	biuo
专政	wvtr
天前	tdqx
知觉	eozu
蠕动	czas
大码	ddtz
英国的	hzu
邻近	isdr
各式	wglv
多家	bbaq
离散	wzak
美感	mdlt
叙事	vxjo
一定很	tad
电缆	fisn
饭菜	mzhe
惊艳	yxkm
无条件	hwi
外经贸	bsp
华中	ilov
引言	cvuy
同盟	ntfk
理工	ehvg
唤醒	omdf
间距	nfbj
隐约	pmss
资源配置	evdc
就好像	xxi
责令	mdis
容颜	awwc
位子	iwiz
也与	uysy
见到了	utd
过长	jryc
心地	cxhu
它所	alzr
我俩	jliz
监理	aneh
转盘	ywbi
孙中山	iow
讨好	ujxi
教程	eimo
努力提高	xsjx
惊慌	yxyh
普遍存在	qqgg
奋力	dnsl
大法	ddvh
昆虫	flcc
全班	sqey
闪过	nijr
病虫	ftcc
温情	vfyl
取样	bxgm
大包	ddsb
臀部	rowo
多得	bbdf
发自	nfcm
理事会	eji
那会	lpia
内政	kntr
掠过	jxjr
商贸	nspm
大姨妈	dxx
钢丝	lnss
我们知道	jieq
相聚	gmbx
彩电	egfi
一打	tyjx
过早	jrfy
好久不见	xmmu
体育馆	ipm
急着	mbmm
听这	odwr
搬到	jbth
神态	dfdu
渗出	vvvc
真美	ygmd
延缓	crse
透明度	mfr
然後	buds
俗话	iwua
菠萝	pghc
公关	mvkd
可望	jkpk
亲亲	nqnq
方能	tfvk
冲进	eour
象是	exft
细胞膜	skk
自负	cmif
上扬	itjl
眼睛里	mmh
施加	tuwj
荷载	hiyl
滋养	vqmu
传真	iwyg
受限	expk
所有者	zge
手动	jsas
博览会	yai
澄清	vbvl
流产	vpwc
抬高	jvxg
表决	mqet
进修	uriw
血腥	cikf
抢到	jjth
这让	wrui
有什么事	gicj
戏曲	xlfa
用作	jyik
其它的	mau
谁有	uygk
拮抗	jkjp
发展观	nrx
举止	zmrz
高职	xgbo
棕色	gamv
心包	cxsb
十几个	yni
有色	gkmv
师大	atdd
面条	tcwg
强悍	coyf
一致性	tty
猕猴	qmqr
明代	fkmd
沸腾	vckn
均是	hsft
还为	mres
直升机	ycg
屏蔽	rqhb
帐篷	bynw
战略性	iny
反腐倡廉	zrir
梗阻	gxpg
这群	wrbc
子宫内膜	iakk
强求	cozu
所造成的	zklu
中途	ovvr
管家	naaq
那是因为	lfze
就象	xvex
两会	zlia
九年	kjev
不敢相信	mdgi
冲着	eomm
通畅	sjfv
因为是	zef
好呀	xiot
事发	jonf
事关	jokd
满是	vhft
世界贸易	unpf
重叠	ahxx
不给力	mss
支付宝	yia
我们班	jie
医护	jejq
磋商	tmns
粉末	kmqm
专家学者	waze
比较大	lyd
柔情	sxyl
贵州省	csm
黑眼圈	dmz
以求	byzu
前锋	qxlw
乔治	cdvv
违法犯罪	wvqc
渡过	vrjr
上流	itvp
胆子	kfiz
开除	thpv
能将	vkqb
诗词	uhue
管理机构	negg
帖子	biiz
等会	nhia
对台	xjvo
提早	jffy
晚年	fmev
就怕	xvyu
一概	tygk
迈进	teur
证人	utir
共鸣	amoe
不规范	myp
咱俩	ociz
甘油	htve
成活	leva
压制	zhqn
老头子	eoi
丢人	atir
二等奖	wnq
构想	gsgm
好歹	xibd
不负责	mim
太冷	duei
曾说	kvuk
待会	dhia
全面推进	stju
大报	ddjp
夜色	pimv
又得	xydf
丹尼	nprl
均值	hsiy
骗我	zqjl
奥地利	uhm
独资	qcef
理学	ehzi
好高	xixg
降落	pwpw
蜘蛛	cecq
名为	boes
之说	gzuk
充值卡	pii
打入	jxcu
山药	wshs
后台	kovo
树枝	gxgy
洗洗	vqvq
这个地方	wiht
热烈欢迎	pbxp
昔日	affr
离别	wzka
犯错	qela
乐于	pvhy
引擎	cvhw
哺乳	ojei
燃气	wuaq
是呀	ftot
为由	esey
不收	mbyw
收起	ywre
甜品	ahoo
苍蝇	hjco
排泄	jbvu
开张	thcy
化身	ilps
得让	dfui
水平线	zhs
天赋	tddt
内脏	knkr
轻工	ybvg
家兔	aqut
太帅	duab
想象中	geo
实际行动	apda
范围内的	pzku
螃蟹	cwmm
氧气	amaq
企事业单位	ijoi
自知	cmeo
新政	ndtr
仍将	ilqb
平安夜	hyp
无尽	hiae
浮动	veas
打倒	jxit
无事	hijo
两级	zlsl
请来	ulqk
交织	prso
但很	ifdk
后卫	kopt
三峡工程	cwvm
逃走	eerz
遗失	cres
好喝	xiof
索性	yayc
银河	lkvj
容积	awmo
木头	gmot
上证	itut
清爽	vldx
伪造	iekr
挂科	jbmk
形体	thig
行政主管	dtpn
很短	dket
储量	iuft
警示	hwns
巡回	srzo
物质文明	qzwf
写完	asaj
屈服	rvkp
透析	mlgd
每个月	eik
段子	doiz
现代的	emu
有风	gknf
写给	assa
大喜	ddkq
原位	zuiw
上访	itut
争执	mbpz
起重	reah
北京人	kxi
应考	rzev
站了起来	wdrq
处理器	weo
不单	mbkf
位数	iwkx
带宽	maah
低落	ippw
之本	gzgt
有家	gkaq
此时此刻	rfrs
却要	hvdx
是哪个	foi
禽兽	iwkn
邮票	epdn
动荡	aspl
一桩	tygr
研究员	tao
来去	qkhv
烟台	wzvo
所为	zres
气流	aqvp
绑定	skat
看不起	jmr
享乐	xipv
以对	byxj
轰动	yxas
圣诞老人	xuei
分局	mfre
它会	alia
雪白	zbub
渗漏	vvvr
男孩子	nii
惊呼	yxoc
选民	qael
塑性	kkyc
杏仁	goiw
交换机	pjg
坐上	iiit
二代	wemd
附件	piiq
原型	zuta
全国性	szy
唱片	oftp
胶质	kpzy
不知所措	mezj
组织结构	sssg
是些	ftrl
又给	xysa
越来越少	rqrm
越狱	rlqd
死神	bldf
耦合	qnao
海带	vema
居委会	rmi
不在于	mgh
关机	kdgn
新房	ndqt
眼线	mkst
连日	yrfr
丢下	atox
质量问题	zfnf
胆管	kfna
万人迷	tik
你知道吗	ieqo
这都是	wef
茄子	hwiz
芬兰	hmqw
出击	vchz
区域经济	jhsv
香气	mfaq
不下去了	mohd
白酒	ubvd
会将	iaqb
活塞	vaau
纸上	spit
憔悴	yyyp
为零	eszi
报社	jpdh
烘干	wahg
不甘心	mhc
许愿	uqzu
秘诀	mcut
市场份额	phia
细则	snda
评委	uhmx
乞丐	egti
车轮	ycyi
滑动	vyas
丰满	kfvh
难民	xyel
有声	gkrs
调味	unoq
骑车	zdyc
我认识	juu
流向	vpuo
日语	fruc
筹资	nkef
关键时刻	klfs
专程	wvmo
恍然	yebu
现代科学	emmz
悲痛	bcfs
半点	cbit
五行	cwdl
骚扰	zxji
胃痛	nkfs
借用	iajy
几下	njox
细化	snil
起初	repm
乾隆	yypw
第一时间	ntfn
病死	ftbl
之比	gzlb
贪官	idau
留恋	pmrc
埋在	hhgh
青山	lqws
除此之外	prgb
之风	gznf
皱眉	mbrm
青春期	lum
灭火	twwh
水域	zshl
条街	wgdb
金山	sjws
悠闲	iwng
耕耘	quqa
各异	wgeh
更没	xfvo
章程	ozmo
兴旺	zmfe
烧了	wldj
文科	wwmk
先进文化	quwi
恐慌	vnyh
玩意儿	ewa
植树	gygx
代理人	mei
相反的	gzu
查找	gfjl
中队	ovpi
上官	itau
喘息	owcm
松弛	gmcu
围棋	zwgm
即日起	kfr
苦涩	hpvm
叙利亚	vmo
久违	muwp
手持	jsjh
党性	zayc
端正	wwtr
不是个	mfi
李瑞环	gee
有机结合	ggsa
嘴上	olit
不要紧	mda
完工	ajvg
指控	jlja
金融业	sto
政府工作	trvi
主要因素	pdzm
忽悠	sdiw
而至	titv
右下	goox
综述	sagu
多少年	bme
刚从	nxii
嘉兴	kqzm
嘿嘿嘿	ooo
平米	hkkm
火炬	whwj
发生后	nck
只顾	omze
三万	cste
繁忙	ewyp
基础性	mty
驻华	zpil
胆小	kfvx
失衡	esdm
和平统一	mhst
口罩	okci
小鬼	vxua
就因为	xze
也受	uyex
偏见	iquj
本系	gtcs
水深	zsva
天平	tdhk
整个世界	giun
强盗	coef
总结经验	kssz
雷达	zndr
前有	qxgk
关切	kdlm
周岁	nhwb
升降	chpw
始终是	xsf
床头	rgot
又见	xyuj
政绩	trsm
不等于	mnh
轻重	ybah
出炉	vcwq
小气	vxaq
到期	thmk
不理解	mem
文书	wwdp
肺结核	ksg
给定	saat
蓄水	hszs
主要问题	pdnf
太远	dujr
背包	klsb
红花	svhi
名声	bors
当面	ebtc
结扎	skji
烧伤	wlie
能进	vkur
根据地	gjh
总体规划	kiyl
善意	mqwf
财务管理	dwne
为了我	edj
产销	wcle
台商	vons
中青年	ole
常在	zbgh
执著	pzhe
受害者	eae
沙龙	vmgl
不累	mbns
增长点	hyi
最后一句	fkts
排球	jbez
人马	irzm
过头	jrot
走回	rzzo
三代	csmd
混淆	vfvx
虚荣	qoxg
少数人	mki
抽搐	jejs
胡思乱想	pnag
相比较	gly
安然	yabu
我自己的	jceu
机构改革	ggec
复苏	efhs
境地	hohu
一艘	tybu
生产要素	cwdm
浮躁	vebo
落到实处	ptaw
互不	tomb
胜过	kcjr
触动	mjas
大过	ddjr
赞叹	qqox
棵树	gfgx
增设	hkuo
也做	uyip
夜宵	piae
测评	vduh
糯米	kzkm
人生中	ico
一群人	tbi
巴格达	vgd
西洋	dxvm
这样一种	wgtm
抓到	jrth
头颅	otir
放纵	twsi
报考	jpev
几年前	neq
抒情	jsyl
车门	ycnm
未成年人	qlei
节假	hpir
经济体制改革	svic
听不懂	omy
任期	ismk
旅程	tcmo
总医院	kjp
稳健	mmib
主轴	pzye
大块	ddht
核武	gstl
我们看到	jijt
玫瑰花	eeh
清凉	vlex
椭圆	ggzo
自如	cmxo
年半	evcb
解救	mjzu
鲜活	rmva
再怎么	ekc
改用	ewjy
轮流	yivp
食指	fsjl
绝无	smhi
抗日战争	jfim
名家	boaq
两百	zltf
黑板	dhgz
祖先	dgqa
面对面	txt
犯贱	qedt
混沌	vfvl
新郎	nduk
是怎样的	fkgu
牢记	aque
抱起	jsre
独具	qcgm
截然	ylbu
周杰伦	ngi
情歌	yljj
安居	yarp
整版	gwtz
低沉	ipva
阿拉法特	pjvq
法师	vhat
遍布	qigb
可要	jkdx
会计师	iua
相通	gmsj
消退	vekr
中国移动	ozma
点缀	itsx
国家安全	zays
发疯	nffn
农副产品	bpwo
约旦	ssft
年份	evim
奇葩	djhu
停顿	ixlz
年代中期	emom
忐忑	itoc
有所不同	gzmn
年终奖	esq
党纪	zase
高位	xgiw
过完	jraj
砖瓦	twfw
江青	vvlq
心理上	cei
蜂群	cwbc
水涨船高	zvbx
调制	unqn
基本建设	mgbu
小包	vxsb
好莱坞	xhh
对家	xjaq
制冷	qnei
吞吐	tdoh
大字	ddai
吸毒	olmo
躺下	peox
主要任务	pdiw
传承	iwdz
两市	zlpb
何在	ijgh
英伦	htii
所爱	zreg
南京市	xxp
以太	bydu
远去	jrhv
小马	vxzm
克莱	pahq
住户	ipqh
个事	ivjo
团伙	zjiw
不生	mbcm
畜生	sncm
使用者	ije
闭上眼睛	nimm
一岁	tywb
文化程度	wimr
创新精神	jnkd
贵人	cgir
犯人	qeir
完饭	ajmz
境外	hobi
情境	ylho
顿饭	lzmz
记起	uere
穿孔	atii
意象	wfex
风筝	nfnm
卡片	iotp
阴暗	pkfw
彷佛	dtic
看一看	jtj
一指	tyjl
冷死	eibl
惭愧	yyyu
数年	kxev
亩产	pnwc
寒冬	auwe
位居	iwrp
被爱	pgeg
高楼	xggk
叫着	oymm
会心	iacx
社会实践	diab
主人公	pim
这样的事	wguj
周内	nhkn
追随	urpg
玩游戏	evx
其他国家	miza
亲本	nqgt
劳累	xsns
江河	vvvj
加速度	wgr
人民出版社	ievd
两样	zlgm
经贸合作	spai
牙膏	txxk
有喜	gkkq
躯体	pjig
迄今为止	eier
边防	srpt
悉尼	ckrl
之为	gzes
医疗机构	jfgg
朴素	gims
压在	zhgh
这条路	wwb
放宽	twah
常人	zbir
下定	oxat
真实性	yay
股骨头	kyo
暗自	fwcm
正值	triy
不要忘记	mdpu
解说	mjuk
有话	gkua
最容易	faf
顺境	stho
统计局	sur
嫂子	xuiz
劳资	xsef
紧接着	ajm
涂抹	vvjq
自重	cmah
家门口	ano
酒杯	vdgm
摆动	jcas
交出	prvc
穿透	atml
蓦然	izbu
扑街	jidb
顺义区	suj
拖拉	jejw
主线	pzst
国家经济	zasv
泡面	vstc
每到	eoth
情商	ylns
使出	ixvc
柚子	geiz
公道	mvqc
可想	jkgm
新区	ndjx
当心	ebcx
心绞痛	csf
邮箱	epng
干线	hgst
已为	eyes
本部	gtwo
减免	elmo
性病	ycft
都可能	ejv
传到	iwth
志趣相投	hrgj
含笑	idnc
未有	qwgk
相片	gmtp
难为	xyes
马桶	zmgs
黑社会	ddi
节假日	hif
负载	ifyl
踊跃	bsbc
薄荷	pjhi
谈了	uwdj
众生	iicm
发生于	nch
几多	njbb
单车	kfyc
单项	kfvt
无能为力	hves
常州	zbsz
聚焦	bxyj
那句话	lsu
申办	fvsm
电热	fipt
互助	togs
驾车	wzyc
烤肉	weki
促成	ible
挥发	janf
唯美	oymd
这些东西	wryd
过生日	jcf
女包	xnsb
挡不住	jmi
变身	rxps
特质	qhzy
架子	wgiz
基建	mhbh
什么样子	icgi
创始	jaxv
归宿	abai
好日子	xfi
别太	kadu
不愧是	myf
多少次	bme
城市规划	hpyl
没有发现	vgne
用语	jyuc
柔性	sxyc
总工	kovg
攻势	vwps
谈不上	umi
能耗	vkqq
鸡肉	xeki
心室	cxat
羡慕嫉妒恨	mixy
遥控	eqja
得自	dfcm
合用	aojy
耶稣	bprm
上清	itvl
四化	zail
不介意	miw
发展前景	nrqf
本色	gtmv
省区	mmjx
年限	evpk
却能	hvvk
创面	jatc
实习生	aec
奋斗目标	dkmg
人民银行	ield
观望	xupk
大庆	ddrd
热卖	ptyd
时效	fjpr
大山	ddws
而定	tiat
刻骨	sayg
就差	xvmv
张扬	cyjl
语义	ucux
木兰	gmqw
队友	pigx
经济运行	svad
泌尿	vcrz
网民	nxel
上厕所	izz
绚丽	sstn
则以	daby
自立	cmwl
遍地	qihu
庄子	rhiz
获胜	hqkc
共建	ambh
头皮	otgp
奔腾	dykn
好意思	xwn
备份	wnim
又有什么	xgic
单人	kfir
页面	tytc
热衷	ptpo
药房	hsqt
一封信	tbi
不可缺少	mjqm
导游	ejvt
造福	krdp
合伙	aoiw
清扫	vljb
这个月	wik
酸性	dvyc
养鸡	muxe
不致	mbth
女孩的	xiu
人本	irgt
始于	xvhy
快活	ytva
毅然	wqbu
多达	bbdr
魔力	rysl
位点	iwit
吸血鬼	ocu
本命	gtao
隔着	ptmm
个屁	ivrl
检察院	gap
支柱产业	ygwo
更多的人	xbui
看样	jmgm
肉类	kikd
缠绵	srsu
黄山	aews
美洲	mdvs
特困	qhzg
反问	zxno
熟料	xkkk
盘点	biit
谅解	uxmj
鸭梨	nema
过时	jrfj
不成熟	mlx
育人	pkir
沙特	vmqh
提着	jfmm
姚明	xefk
准入	eycu
变频	rxrm
中国革命	ozca
年历	evzs
更显	xffo
漫游	vfvt
经得起	sdr
谢谢大家	uuda
促进作用	iuij
火花	whhi
首诗	qcuh
改装	ewqh
哭得	oodf
跌幅	bebp
通了	sjdj
心血管病	ccnf
当然要	ebd
歌剧	jjrp
看清楚	jvy
一国两制	tzzq
派对	vzxj
题为	fres
君主	bcpz
罪过	cbjr
同上	ntit
外星人	bfi
霸王	zcew
车队	ycpi
化验	ilza
偏离	iqwz
且有	gqgk
国土资源	zhev
术语	guuc
总计	kouy
谁就	uyxv
眼部	mkwo
电站	fiwi
经销商	sln
烟雾	wzzw
想一想	gtg
前年	qxev
而作	tiik
局限于	rph
过关	jrkd
仅在	ixgh
哪能	olvk
期待着	mdm
到晚	thfm
翻到	cnth
如果要	xfd
饲喂	meon
黄芪	aehp
宽阔	ahnv
微量元素	ffjm
不是吧	mfo
足迹	bzrr
工作室	via
么么	cvcv
空空	avav
汇集	vjyg
如果她	xfx
华山	ilws
修行	iwdl
经济利益	svmq
用它	jyal
试试看	uuj
国务院总理	zwpe
查明	gffk
三尺	csac
梯度	gkrh
汤姆	vlxo
稍稍	meme
九个	kjiv
人眼	irmk
闪耀	niea
千金	aqsj
夺冠	djaj
而与	tisy
迎面	pptc
停机	ixgn
零点	ziit
旁人	wtir
游人	vtir
涵盖	vdmi
京东	xvyv
非公有制经济	bmgv
安好	yaxi
繁重	ewah
梦境	ybho
当务	ebws
别无	kahi
鸭子	neiz
就意味着	xwom
得益	dfqm
肝硬化	kti
忘却	pchv
国有经济	zgsv
小脸	vxka
在变	ghrx
沿途	vnvr
明晚	fkfm
没电	vofi
首页	qcty
某个人	hii
乔布斯	cgm
富人	apir
所有这些	zgwr
复仇	efik
陶醉	psdp
每位	eoiw
咆哮	osoe
喝完	ofaj
奥迪	uker
讲授	uuje
有组织	gss
这会儿	wia
远期	jrmk
冰凉	ezex
功能障碍	vvpt
各人	wgir
了得	djdf
劳动生产	xacw
起作用	rij
这期	wrmk
输给	yasa
排在	jbgh
方可	tfjk
摆放	jctw
过日子	jfi
新鲜事	nrj
科学化	mzi
模态	gidu
看来是	jqf
最痛	fbfs
点儿	itae
王八	ewmb
经营权	sxg
用眼	jymk
乘车	mkyc
皮衣	gppy
和亲	monq
当务之急	ewgm
乱了	aidj
到会	thia
小结	vxsk
用尽	jyae
油脂	vekl
娘子	xuiz
沉浸在	vvg
缺水	qtzs
代表着	mmm
不识	mbuo
强制性	cqy
称作	mmik
客观上	axi
学术界	zgn
两旁	zlwt
几个字	nia
天黑	tddh
婴幼儿	dsa
顶部	xtwo
团团	zjzj
无边	hisr
脚步声	krr
导入	ejcu
版权	tzgx
懦弱	yzce
整洁	gwvk
作法	ikvh
此案	rlyg
荒唐	hprb
将此	qbrl
也和	uymo
过失	jres
热泪	ptvm
躲避	pnrw
夜深	piva
独孤	qcir
对准	xjey
北京时间	kxfn
大学毕业	dzlo
这次的	weu
可耻	jkbr
下降了	opd
再做	enip
翻出	cnvc
强国	coze
开到	thth
泄露	vuzb
湿热	vfpt
罗斯	cbmd
花草	hihf
吃多	oebb
买点	doit
纳闷	sknc
这么难	wcx
省份	mmim
报导	jpej
删了	sadj
类似于	kih
村委	gjmx
几件	njiq
独生	qccm
情不自禁	ymcy
闭塞	njau
这样的话	wguu
时辰	fjzq
不是为了	mfed
说了一句	udts
碱性	tlyc
新闻媒体	nnxi
演技	vajy
野心	hscx
用好	jyxi
摄氏	jbpl
过人	jrir
议长	uuyc
猫猫	qhqh
连环	yrem
补肾	piax
一元	tyjy
年少	evms
财源	djvz
都是一个	efti
党校	zagp
坚韧	axwp
发展速度	nrgr
才算	jcnm
现代文	emw
科学文化	mzwi
礼包	disb
领略	isnw
这周	wrnh
滋生	vqcm
腹胀	keky
点了点头	idio
早点睡	fim
举世	zmus
快看	ytjm
之重	gzah
因特	zdqh
之称	gzmm
合照	aofm
重温	ahvf
自尊心	cqc
修炼	iwwl
内向	knuo
忍着	mumm
超额	rmaw
转走	ywrz
很多东西	dbyd
朴实	giao
代言人	mui
西方的	dtu
还多	mrbb
场上	hlit
活下去	voh
中用	ovjy
远大	jrdd
偿还	iemr
喊着	olmm
用完	jyaj
中国企业	ozio
名利	boma
社会进步	diur
还是没有	mfvg
很忙	dkyp
博大	yjdd
死也	bluy
这个事	wij
攻坚	vwax
讲课	uuuf
橡皮	gegp
斗志	kdhc
启蒙	qoxw
武汉市	tvp
天安	tdya
例行	ibdl
惊恐	yxvn
冰淇淋	evv
史料	oxkk
挑起	jere
痴呆	feog
原则上	zdi
文凭	wwis
初二	pmwe
给它	saal
蝴蝶结	ccs
自然环境	cbeh
一拳	tynj
垂下	aaox
持股	jhko
见效	ujpr
不言	mbuy
更改	xfew
去向	hvuo
迷你	krim
到死	thbl
猜想	qlgm
宣称	atmm
刑事责任	tjmi
右上	goit
兄妹	oaxq
上完	itaj
黯然	dwbu
振荡	jzpl
胎盘	kvbi
虐待	qbdh
放映	twft
血肉	ciki
输血	yaci
诚恳	ulkc
肌瘤	knfp
专一	wvty
想了想	gdg
比如说	lxu
选购	qads
洞穴	vnax
通电	sjfi
参政	vdtr
往日	dpfr
选修	qaiw
总想	kogm
生产厂家	cwza
直属	ygrc
负有	ifgk
宽广	ahrg
才开始	jtx
近乎	drck
辜负	pwif
我喜欢你	jkxi
被杀	pgxg
企鹅	irjl
暴风	fanf
轰轰烈烈	yybb
最简单	fnk
刘备	wawn
变色	rxmv
新村	ndgj
国际经济	zpsv
教育局	epr
车道	ycqc
典范	nape
标语	gnuc
抄底	jmrp
下放	oxtw
如今的	xiu
划算	lanm
新衣	ndpy
评为	uhes
锁定	leat
那块	lpht
猛击	qihz
简历	nnzs
细微	snfn
都是这样	efwg
战后	ilko
里来	hlqk
航行	bpdl
它们是	aif
装有	qhgk
陈列	pyba
鼓起	kqre
制度建设	qrbu
店主	ripz
应试	rzul
客场	awhl
东山	yvws
并从	qhii
这是我的	wfju
睁大	mmdd
有血	gkci
大公司	dme
胃镜	nklo
淋漓	vyvw
洛杉矶	vgt
悬浮	gvve
拿回	aozo
独立性	qwy
质感	zylt
长出	ycvc
奶油	xlve
立项	wlvt
本单位	gki
扰乱	jiai
很差	dkmv
乌鲁木齐	ergw
你猜	imql
村子	gjiz
屠宰	reaw
绩效	smpr
新民	ndel
学好	zixi
勘探	mija
哈哈大笑	oodn
火烧	whwl
瓜子	rgiz
以及其他	blmi
之首	gzqc
实用性	ajy
母本	omgt
测出	vdvc
剧中	rpov
考证	evut
业已	oyey
日光	fret
布满	gbvh
愿你	zuim
发展过程中	nrjo
安稳	yamm
引领	cvis
灯笼	wxng
天气预报	tasj
也由	uyey
注明	vpfk
不承认	mdu
来袭	qkgp
爱得	egdf
降低成本	pilg
国安	zeya
自言	cmuy
表层	mqra
别这样	kwg
独一无二	qthw
火车票	wyd
折叠	jdxx
归根	abgk
演习	vaex
过上	jrit
拔出	jnvc
彼得	dgdf
测验	vdza
语言学	uuz
如果可以	xfjb
形式上	tli
不完善	mam
真挚	ygpj
接着说	jmu
玩家	ejaq
觉醒	zudf
揭晓	jffl
两颗	zlfg
几日	njfr
之法	gzvh
风险投资	npje
拇指	jojl
细胞核	skg
租金	mgsj
这道	wrqc
连同	yrnt
油气	veaq
不见得	mud
钻研	litt
现实主义	eapu
考上	evit
鸡翅	xeyx
所受	zrex
老爹	elrb
样式	gmlv
复合材料	eagk
始终坚持	xsaj
话筒	uann
休假	igir
专栏	wvgq
抽屉	jeru
打印机	jpg
合作伙伴	aiii
凶残	xzbt
珊瑚	esep
虽然没有	obvg
买回	dozo
西药	dxhs
调查表	ugm
亿万	igte
山下	wsox
救人	zuir
一并	tyqh
两岸关系	zwkc
接纳	jwsk
千克	aqpa
掌控	zjja
求出	zuvc
一个多月	tibk
狠狠地	qqh
限期	pkmk
而未	tiqw
味儿	oqae
下一代	otm
枸杞	gsge
硝酸	tedv
科学知识	mzeu
联系起来	bcrq
戒烟	lhwz
吉利	kjma
文化交流	wipv
才说	jcuk
奢侈品	dio
见不到	umt
一步步	trr
依法行政	ivdt
增值税	him
二两	wezl
晕了	fadj
这样吧	wgo
考场	evhl
想笑	gmnc
下决心	oec
等一下	nto
充分肯定	pmra
情调	ylun
喝点	ofit
汤圆	vlzo
交接	prjw
多边	bbsr
共产党人	awzi
冷空气	eaa
唐山	rbws
好好学习	xxze
眼珠	mkeq
表格	mqgw
成交量	lpf
如愿	xozu
英镑	htlw
两道	zlqc
迫不及待	umld
大神	dddf
核武器	gto
追上	urit
授课	jeuf
美貌	mdqu
城建	hlbh
表态	mqdu
红灯	svwx
丙烯	tkwx
结成	skle
高端	xgww
果树	fggx
毫不犹豫	xmqs
向东	uoyv
比尔	lbmv
国库	zery
各区	wgjx
产地	wchu
饰品	meoo
哇咔咔	ooo
松开	gmth
唠叨	oxom
小生	vxcm
赛车	auyc
可别	jkka
盗版	eftz
传染性	ivy
欢笑	xfnc
雨天	zytd
诸位	ueiw
瘦肉	fuki
恐怖主义	vypu
表皮	mqgp
迟迟	arar
对外贸易	xbpf
地貌	huqu
娘娘	xuxu
佳人	ibir
建筑材料	bngk
体育场	iph
条腿	wgkk
高度评价	xrui
有关系	gkc
为好	esxi
依法治国	ivvz
女足	xnbz
我就知道	jxeq
冷汗	eivh
部委	womx
分公司	mme
被盗	pgef
韧性	wpyc
小路	vxbw
晒太阳	fdp
来啊	qkop
恩格斯	zgm
好办	xism
多长	bbyc
排练	jbsl
准了	eydj
通常是	szf
床边	rgsr
笔下	nqox
致死	thbl
吸引人	oci
出厂	vczc
从何	iiij
棒子	guiz
足足	bzbz
猕猴桃	qqg
高龄	xgrz
哥伦比亚	jilo
诸葛亮	uhx
大搞	ddjx
穿得	atdf
乐乐	pvpv
理科	ehmk
红薯	svhc
高性能	xyv
取缔	bxsw
每股	eoko
时报	fjjp
互利	toma
价位	iiiw
一块儿	tha
并举	qhzm
小熊	vxvl
意想	wfgm
牵头	daot
为准	esey
简短	nnet
铁杆	legh
基本上是	mgif
百科	tfmk
每组	eosg
各国人民	wzie
没有时间	vgfn
台下	voox
待人	dhir
课文	ufww
尿素	rzms
大清早	dvf
抑或	jplo
总成	kole
社科	dhmk
罪名	cbbo
私下	mvox
两分	zlmf
百余	tfvy
操场	johl
这把	wrjv
年货	evil
亟待	djdh
徒弟	drkc
野生动物	hcaq
供需	iazt
有罪	gkcb
渐渐地	vvh
三类	cskd
哲理	jdeh
过重	jrah
立于	wlhy
几个小时	nivf
校服	gpkp
谋求	uhzu
电线	fist
一幢	tybw
政治家	tva
坚持不懈	ajmy
流转	vpyw
那叫	lpoy
记者招待会	ueji
越长	rlyc
感谢大家	luda
无数的	hku
雌激素	rvm
起始	rexv
德国的	dzu
她就是	xxf
智者	eoez
认识论	uuu
轮到	yith
小猪	vxqe
捍卫	jfpt
眼底	mkrp
子公司	ime
指明	jlfk
拿走	aorz
肚子里	kih
这个名字	wiba
本想	gtgm
升学	chzi
经国	sbze
艺术节	hgh
大潮	ddvy
大象	ddex
马列主义	zbpu
不断增加	mkhw
回声	zors
长处	ycwi
定居	atrp
崇尚	waes
得去	dfhv
民族团结	etzs
实证	aout
名额	boaw
更不能	xmv
脸部	kawo
摔倒	jpit
匆忙	sdyp
间歇	nffi
常见病	zuf
但是我们	ifji
买下	doox
想开	gmth
正直	tryg
滑稽	vymu
继续努力	ssxs
憧憬	ywyf
编剧	sqrp
保鲜	iorm
活该	vaus
研究方法	tatv
摇晃	jefe
旗舰店	tbr
花瓣	hiwr
想不想	gmg
综合素质	samz
世代	usmd
事例	joib
覆盖率	dmp
新奇	nddj
一遇	tynn
又怕	xyyu
根系	gkcs
思想观念	ngxi
领带	isma
从来就	iqx
参议	vduu
较短	ypet
现实生活中	eaco
我个人	jii
给谁	sauy
商品经济	nosv
国务委员	zwmo
即有	kpgk
都认为	eue
野外	hsbi
名将	boqb
高声	xgrs
官网	aunx
查阅	gfnk
急切	mblm
山谷	wswg
保重	ioah
分泌物	mvq
是神马	fdz
那颗	lpfg
他们自己	iice
白玉	ubeu
成全	lesq
预示	sxns
绵羊	sumy
地市	hupb
几方面	ntt
记忆力	uys
妓女	xyxn
真不错	yml
确是	tmft
票价	dnii
后宫	koao
一个晚上	tifi
立足于	wbh
求求	zuzu
平坦	hkhf
新陈	ndpy
谣言	ueuy
每逢	eowk
无以	hiby
迈克	tepa
输卵管	ypn
威尔	ltmv
年夜	evpi
某部	htwo
淡水	vwzs
金蛋	sjdr
养老保险	meip
由衷	eypo
餐馆	ixma
两万	zlte
这间	wrnf
好几次	xne
少年儿童	meaw
凭证	isut
影响因素	fozm
有钱人	gli
大出	ddvc
居高	rpxg
别把	kajv
献身	xdps
听歌	odjj
中场	ovhl
报价	jpii
汽车工业	vyvo
办事处	sjw
悬崖	gvwz
冲上	eoit
探头	jaot
新阶段	npd
没看见	vju
相当一部分	getm
紧握	axjr
复印	efpp
没打	vojx
不悦	mbyk
银杏	lkgo
真他妈	yix
大不了	dmd
行政处罚	dtwc
营养不良	xmmu
痛哭	fsoo
口吻	okos
民心	elcx
扣除	jopv
五天	cwtd
找到一个	jtti
当着	ebmm
老区	eljx
经常性	szy
喧嚣	oaoo
纵然	sibu
肝素	khms
首家	qcaq
迷路	krbw
用到	jyth
要得	dxdf
死死	blbl
保姆	ioxo
有多么	gbc
工作作风	viin
药用	hsjy
一种人	tmi
仍可	iljk
跟人	bkir
自主权	cpg
必需的	czu
姐夫	xgyf
切入	lmcu
用工	jyvg
决不会	emi
接电	jwfi
没意思	vwn
资深	efva
巨型	jrta
下床	oxrg
总比	kolb
散了	akdj
积极推进	mgju
管用	najy
脑海里	kvh
很多很多	dbdb
市里	pbhl
吃完饭	oam
加倍	wjiw
摇滚	jevp
中间的	onu
阶梯	pigk
重力	ahsl
宁德	andy
发展史	nro
容貌	awqu
颠覆	ymdd
不太好	mdx
基本原理	mgze
应由	rzey
之极	gzgl
什么问题	icnf
备案	wnyg
增量	hkft
做生意	icw
可你	jkim
留有	pmgk
伺候	ieir
并肩	qhqk
爆笑	wfnc
紧跟	axbk
深知	vaeo
持续性	jsy
世纪初	usp
一楼	tygk
停住	ixip
消费品	vco
展览会	rai
追寻	urbj
岛上	ewit
前些	qxrl
丝绸	sssn
望向	pkuo
搞清	jxvl
超载	rmyl
医护人员	jjio
额外	awbi
车里	ychl
成千	leaq
低分	ipmf
想成	gmle
对联	xjbk
多高	bbxg
朝鲜人	yri
成名	lebo
有错	gkla
有意识	gwu
那么多人	lcbi
出奇	vcdj
哪来	olqk
呐喊	okol
奋发	dnnf
果子	fgiz
四天	zatd
想得到	gdt
时钟	fjlo
吃水	oezs
抓着	jrmm
冲天	eotd
马尾	zmrq
县里	gvhl
格拉	gwjw
安抚	yajh
最好是	fxf
身着	psmm
考研	evtt
湖泊	vpvu
财神	djdf
世界大战	undi
不妥	mbex
总产量	kwf
不好看	mxj
成套	ledd
强壮	coqh
为爱	eseg
最棒	fbgu
为先	esqa
温饱	vfms
枯燥	gpwo
概况	gkeo
骑马	zdzm
自力	cmsl
骨肉	ygki
抉择	jtjx
责备	mdwn
政府职能	trbv
各处	wgwi
太长	duyc
农牧	bqqw
干得	hgdf
发现问题	nenf
不确定性	mtay
一直以来	tybq
染料	vkkk
银行卡	ldi
大屏	ddrq
波形	vgth
颠倒	ymit
这个社会	widi
顶着	xtmm
黄浦	aevj
异型	ehta
动感	aslt
中考	ovev
系统性	csy
竞争对手	wmxj
大问题	dnf
配料	dekk
甘蔗	hthr
过期	jrmk
编辑部	syw
病患	ftoo
透气	mlaq
语调	ucun
极点	glit
发音	nfwf
只占	omiz
外头	biot
暴发	fanf
煎熬	qxft
结束语	sgu
看样子	jgi
小家伙	vai
向左	uogv
谁家	uyaq
走入	rzcu
航空公司	bame
文化遗产	wicw
线粒体	ski
竟有	ojgk
只是因为	ofze
人与自然	iscb
无话	hiua
草坪	hfhh
客商	awns
保住	ioip
庆典	rdna
受力	exsl
急促	mbib
累累	nsns
不减	mbel
生怕	cmyu
大吼	ddoi
领到	isth
一员	tyod
是应该	fru
奥斯卡	umi
周到	nhth
船只	bnom
往返	dpzx
白马	ubzm
新陈代谢	npmu
穿梭	atgv
全队	sqpi
二位	weiw
痛楚	fsyd
某种意义	hmwu
口感	oklt
马丁	zmxd
短裤	etpr
石狮	tsqt
年青	evlq
安安	yaya
少说	msuk
收盘	ywbi
对流	xjvp
我们需要	jizd
肮脏	kpkr
落入	pwcu
文化部	wiw
苏醒	hsdf
我勒个去	jcih
应聘	rzbe
社会主义制度	dipr
大麦	ddmw
历史时期	zofm
下限	oxpk
这样啊	wgo
好好地	xxh
调理	uneh
畏惧	nqyg
是什么呢	fico
帝都	wbep
闲置	ngcy
订购	uxds
剪刀	qxmd
轻视	ybdu
干啥	hgoa
罗马尼亚	czro
向南	uoxq
刚性	nxyc
双臂	xxrw
这意味着	wwom
分不清	mmv
床垫	rgph
还剩	mrmk
划分为	lme
二号	weov
来之不易	qgmf
报销	jple
异物	ehqs
体能	igvk
坦率	hfps
折射	jdpj
后生	kocm
也常	uyzb
应用程序	rjmr
宽敞	ahew
学长	ziyc
最需要	fzd
派遣	vzcu
百里	tfhl
改了	ewdj
有意思的	gwnu
这样一来	wgtq
丢脸	atka
不早	mbfy
忠于	ovhy
最大化	fdi
一亮	tyxn
亲朋	nqkk
值得我们	idji
潜水	vyzs
兄弟姐妹	okxx
青菜	lqhe
松动	gmas
冷落	eipw
语境	ucho
占有率	igp
摆出	jcvc
机车	gnyc
党外	zabi
国防部长	zpwy
卑鄙	uboz
河边	vjsr
连队	yrpi
大全	ddsq
触发	mjnf
爱上你	eii
为了什么	edic
献血	xdci
心甘	cxht
碳化	twil
二战	weil
怀旧	ymvf
专业户	woq
上心	itcx
无处不在	hwmg
现实意义	eawu
科比	mklb
优劣	iims
引出	cvvc
末端	qmww
诗意	uhwf
非常高	bzx
改变自己	erce
扭亏	jowv
极有	glgk
接下来的	joqu
学学	zizi
延误	cruo
试题	ulfr
大屏幕	dri
孩儿	isae
也已经	ues
政协委员	tymo
牛排	qnjb
县市	gvpb
一颗心	tfc
逃出	eevc
辗转	yryw
永远不要	ujmd
生猪	cmqe
大江	ddvv
分区	mfjx
新手	ndjs
蛋鸡	drxe
灌浆	vhqb
建行	bhdl
也没什么	uvic
一集	tyyg
一盒	tyao
英国人	hzi
风尚	nfes
连续性	ysy
六百	pmtf
鞠躬	cspc
就只能	xov
孔雀	iivy
管理员	neo
陆地	phhu
不愉快	myy
下酒	oxvd
平庸	hkrb
拜拜	jtjt
拉面	jwtc
再三	encs
爱尔兰	emq
音像	wfie
芳香	htmf
想通	gmsj
迫害	urak
订阅	uxnk
盘子	biiz
紧紧围绕	aazs
南极	xqgl
有利条件	gmwi
班上	eyit
肥大	kvdd
竹子	nziz
爱看	egjm
救护	zujq
冷血	eici
湖州	vpsz
祖父	dgrf
交响	prou
月全食	ksf
负面影响	itfo
拉美	jwmd
禅师	dkat
袋子	mpiz
经纪人	ssi
被选	pgqa
些许	rluq
白人	ubir
自言自语	cucu
在读	ghuy
后世	kous
雅典	txna
山村	wsgj
太早	dufy
不顾一切	mztl
不过来	mjq
夏日	tmfr
这么个	wci
清单	vlkf
西欧	dxjx
危及	mzlj
心胸	cxks
只对	omxj
层楼	ragk
老二	elwe
传入	iwcu
跟不上	bmi
守着	ajmm
不冷	mbei
汉堡	vxio
民族文化	etwi
长辈	ycby
文化生活	wicv
削减	ekel
填充	hypa
教育资源	epev
只管	omna
天主	tdpz
行者	dlez
痛心	fscx
落泪	pwvm
半空	cbav
洁白	vkub
铝合金	las
战略目标	inmg
小雪	vxzb
若要	hgdx
从没有	ivg
交错	prla
一扇	tyqb
挑剔	jefd
增重	hkah
两步	zlrm
这幅	wrbp
耳光	beet
大型企业	dtio
表妹	mqxq
实名制	abq
顺流而下	svto
统治者	sve
纸条	spwg
什么都没有	iceg
看一下	jto
肾上腺素	aikm
上诉	itud
只是一种	oftm
更多的是	xbuf
无数次	hke
有期徒刑	gmdt
必然的	cbu
真假	ygir
处长	wiyc
发售	nfyo
买票	dodn
急了	mbdj
发货	nfil
还是一个	mfti
我们国家	jiza
报上	jpit
技艺	jyhg
取下	bxox
传闻	iwnb
外墙	bihy
并给	qhsa
成年人	lei
问鼎	nomt
钟头	loot
墙面	hytc
高标准	xge
仅限	ixpk
一席	tyrh
高等院校	xnpg
般地	bohu
社会主义国家	dipa
开展工作	trvi
并按	qhjy
懒惰	ygyg
山路	wsbw
快餐	ytix
就问	xvno
查获	gfhq
身亡	pspw
敷衍	jtdv
毛细血管	qscn
胆汁	kfvy
最根本	fgg
找来	jlqk
最高人民法院	fxip
稀土	mxht
路程	bwmo
温室	vfat
壁画	rwtn
相配	gmde
和谈	mouw
运送	arkd
五彩	cweg
深有	vagk
零下	ziox
偏高	iqxg
往常	dpzb
蓝牙	hatx
花瓶	hiqh
生物技术	cqjg
现今	euid
蒸馏	hdmm
好多了	xbd
四海	zave
蕴含	hsid
他自己的	iceu
遵照	qjfm
改革发展	ecnr
醒目	dfmm
老三	elcs
毅力	wqsl
舒缓	apse
因特网	zqn
头孢	otis
液化	vpil
但见	ifuj
恐龙	vngl
为非	esbf
劲儿	bvae
跪下	bmox
都曾	epkv
向西	uodx
之有	gzgk
特级	qhsl
迟钝	arll
物流	qsvp
属下	rcox
大意	ddwf
退回	krzo
相一致	gtt
万万	tete
李白	giub
追赶	urrh
文选	wwqa
三名	csbo
拍下	juox
随时随地	pfph
挺有	jsgk
推断	jyki
周刊	nhha
过夜	jrpi
怎么办呢	kcso
疤痕	fvfk
同在	ntgh
影城	fvhl
全面贯彻	stod
抢先	jjqa
第三代	ncm
冰糖	ezkr
画了	tndj
意义上说	wuiu
自认	cmui
丰田	kfnt
一直以为	tybe
喜怒	kqxx
中转	ovyw
坟墓	hwih
公司法	mev
趁着	rimm
慈悲	qsbc
多在	bbgh
骨架	ygwg
无线电	hsf
不是这样	mfwg
真菌	yghz
伤寒	ieau
非典型肺炎	bntw
水解	zsmj
跑过	bsjr
大卫	ddpt
一个半	tic
不注意	mvw
换取	jmbx
权威性	gly
装甲	qhnj
富于	aphy
惊天	yxtd
每天早上	etfi
这帮	wrkp
日用	frjy
踢球	bfez
叫醒	oydf
太低	duip
野兽	hskn
认错	uila
天花板	thg
马甲	zmnj
售后服务	ykkw
围墙	zwhy
办起	smre
走人	rzir
矿泉	truz
后遗症	kcf
诸侯	ueir
越来越好	rqrx
没有谁	vgu
也不必	umc
抬起头来	jroq
工作岗位	viwi
白宫	ubao
佳作	ibik
是一名	ftb
快感	ytlt
怎么啦	kco
一般认为	tbue
一次又一次	texe
平板电脑	hgfk
酸痛	dvfs
锁骨	leyg
雄性	gvyc
后头	koot
没在	vogh
福气	dpaq
广电	rgfi
心存	cxgi
心理素质	cemz
萌发	hfnf
相册	gmsc
美图	mdzw
木板	gmgz
八十年代	myem
体育锻炼	iplw
风力	nfsl
巴以	vbby
密集型	ayt
巧合	vvao
分行	mfdl
跳起来	brq
也把	uyjv
椎间盘突出	gnbv
打麻将	jrq
改天	ewtd
居室	rpat
压强	zhco
日均	frhs
打仗	jxix
台湾同胞	vvnk
不同的是	mnuf
活生生	vcc
政治局	tvr
发展成为	nrle
去处	hvwi
骑着	zdmm
重返	ahzx
去年底	her
那首	lpqc
清算	vlnm
完蛋	ajdr
搬家	jbaq
持续时间	jsfn
乌云	eway
波特	vgqh
汉族	vxte
纤维素	ssm
意想不到	wgmt
上调	itun
抢险	jjpa
劳动生产率	xacp
了解了	dmd
人质	irzy
是什么人	fici
都到	epth
五官	cwau
金黄色	sam
摇了摇	jdj
她不是	xmf
家住	aqip
没有一点	vgti
大肠杆菌	dkgh
两部分	zwm
软化	yfil
肾病	axft
出境	vcho
好孩子	xii
皆有	lugk
芹菜	hdhe
出走	vcrz
关在	kdgh
更喜欢	xkx
有的时候	gufi
公公	mvmv
交待	prdh
退耕	krqu
没有看到	vgjt
下级	oxsl
全国范围	szpz
车身	ycps
线圈	stzn
氧化物	aiq
有主	gkpz
日志	frhc
哪怕是	oyf
犹太人	qdi
不急	mbmb
想不出	gmv
受不了了	emdd
统计数据	sukj
贮藏	dahl
面对着	txm
随风	pgnf
重现	aheu
山楂	wsgg
工农业	vbo
坦诚	hful
比较多	lyb
极强	glco
新车	ndyc
所选	zrqa
那一年	lte
试探	ulja
良知	ukeo
务工	wsvg
小巧	vxvv
已经不是	esmf
好长	xiyc
火了	whdj
扎扎实实	jjaa
这个意义	wiwu
综合症	saf
看个	jmiv
继续教育	ssep
夏侯	tmir
隐性	pmyc
经济形势	svtp
多渠道	bvq
共同点	ani
法子	vhiz
这小子	wvi
拉出	jwvc
橙子	gbiz
战鼓	ilkq
好生	xicm
兄弟们	oki
出品	vcoo
建筑师	bna
对华	xjil
管理层	ner
我们之间	jign
变速	rxgo
肩头	qkot
侦探	iija
球星	ezfc
青藏	lqhl
无影	hifv
欺诈	mfuk
蜂王	cwew
这么多人	wcbi
精简	klnn
中线	ovst
外衣	bipy
红楼梦	sgy
早有	fygk
全书	sqdp
四千	zaaq
颓废	mnrn
小牛	vxqn
上头	itot
那一个	lti
咀嚼	ogoe
评级	uhsl
专场	wvhl
有难	gkxy
不管怎么	mnkc
集体经济	yisv
能以	vkby
历史条件	zowi
谁敢	uydb
随着时间	pmfn
星期三	fmc
全国人民代表大会	szii
粉红色	ksm
中国银行	ozld
联系在一起	bcgr
下载地址	oyhh
如实	xoao
刚果	nxfg
也行	uydl
不按	mbjy
电报	fijp
壁纸	rwsp
占到	izth
奖学金	qzs
较重	ypah
作好	ikxi
管好	naxi
单体	kfig
两头	zlot
强者	coez
历史发展	zonr
该校	usgp
特效	qhpr
身穿	psat
几名	njbo
顺心	stcx
勘察	miab
给个	saiv
坐起	iire
天色	tdmv
和谁	mouy
标的	gnus
一米	tykm
三步	csrm
中国历史	ozzo
篇幅	nqbp
筹措	nkja
光阴	etpk
安逸	yaur
医疗保险	jfip
包含着	sim
出家	vcaq
可以考虑	jbeq
弟兄	kcoa
可否	jkmo
全部的	swu
若不是	hmf
荒山	hpws
原来如此	zqxr
接吻	jwos
太爱	dueg
鸟儿	enae
法国的	vzu
棺材	gagj
结了	skdj
灰白	gwub
上校	itgp
挣脱	jmkk
晶莹	ffxe
进水	urzs
新时代	nfm
选了	qadj
一枝	tygy
于是就	hfx
生产方式	cwtl
不完全统计	masu
马达	zmdr
数码相机	ktgg
比不上	lmi
违约	wpss
可操作	jji
捡到	jath
也许就	uux
石英	tsht
泥石流	vtv
钻头	liot
样子的	giu
却因	hvzd
差错	mvla
组装	sgqh
此生	rlcm
大本营	dgx
裁决	ylet
使馆	ixma
查办	gfsm
与民	syel
生平	cmhk
好一会	xti
武力	tlsl
印记	ppue
富士	aphs
远在	jrgh
表现形式	metl
巴士	vbhs
课件	ufiq
因病	zdft
老哥	eljj
采纳	egsk
身处	pswi
母子	omiz
中国特色的社会主义	ozqu
领着	ismm
列举	bazm
猎人	qair
国度	zerh
新作	ndik
番话	ckua
精通	klsj
公积	mvmo
调和	unmo
基础研究	mtta
笑点	ncit
而从	tiii
就读	xvuy
可调	jkun
火腿	whkk
所含	zrid
支书	yxdp
套房	ddqt
成天	letd
脱颖而出	kltv
幻觉	sezu
均能	hsvk
理应	ehrz
信息资源	icev
有困难	gzx
狂风	qenf
月球	kyez
电话号码	fuot
知不知道	emeq
光亮	etxn
索取	yabx
全世界的	sunu
风中	nfov
那么一个	lcti
一匹	tyja
一气	tyaq
做着	ipmm
王菲	ewhb
脑筋	kwnk
不力	mbsl
向日	uofr
殿下	raox
胸膜	kski
学了	zidj
装着	qhmm
这种方式	wmtl
母鸡	omxe
稿件	mxiq
打人	jxir
一桌	tyif
瞩目	mrmm
少儿	msae
数以	kxby
看守	jmaj
午睡	qwma
日落	frpw
盛开	leth
独有	qcgk
跑车	bsyc
武夷山	tdw
盛行	ledl
宫廷	aosr
还与	mrsy
两层	zlra
集中力量	yosf
风湿	nfvf
搜寻	jubj
协和	ysmo
日新	frnd
施用	tujy
没心没肺	vcvk
反恐	zxvn
世博会	uyi
初见	pmuj
信封	iubj
改组	ewsg
樱花	gdhi
社会生产力	dics
欠缺	fqqt
站住	wiip
公积金	mms
进屋	urrt
星期四	fmz
多事	bbjo
额度	awrh
合乎	aock
一致认为	ttue
脉搏	kujj
过硬	jrtx
武士	tlhs
批号	jlov
之行	gzdl
又让	xyui
多糖	bbkr
打成	jxle
斑点	ewit
基础上的	mtiu
笑了起来	ndrq
旋风	tdnf
一缕	tysk
吓了一跳	odtb
幽灵	wsbw
乳酸	eidv
创下	jaox
看得见	jdu
历年	zsev
藏书	hldp
遗憾的是	cyuf
团聚	zjbx
飘飘	dndn
不实	mbao
上限	itpk
上月	itky
议题	uufr
蹲在	bqgh
沉吟	vaoi
疏通	drsj
下地	oxhu
一刹那	txl
某种意义上	hmwi
欣然	dfbu
区域性	jhy
不一定是	mtaf
技术性	jgy
一连串	tyo
高涨	xgvc
六七	pmlq
仙人	iwir
巴萨	vbhp
建筑工程	bnvm
中国现代	ozem
甘肃省	hbm
够用	sojy
纱布	smgb
开枪	thgj
一些国家	trza
全无	sqhi
先走	qarz
走动	rzas
收割	ywao
清朝	vlyy
管理学	nez
损耗	joqq
睾丸	ccku
海面	vetc
文盲	wwpm
心肌梗塞	ckga
修辞	iwaw
良性循环	uyde
合作社	aid
这么久	wcm
屋内	rtkn
老乡	elsc
操心	jocx
很热	dkpt
间房	nfqt
烤烟	wewz
埋头	hhot
黄豆	aeto
雏鸡	mbxe
本就	gtxv
迎新	ppnd
地球人	hei
附属医院	prjp
乳胶	eikp
虔诚	qwul
任何的	iiu
无言	hiuy
接电话	jfu
邂逅	mmko
市场营销	phxl
读到	uyth
积压	mozh
中层	ovra
早年	fyev
捷克	jtpa
人事部	ijw
行业协会	doyi
挽留	jmpm
送往	kddp
检察官	gaa
心悸	cxym
单向	kfuo
赫然	hrbu
停产	ixwc
干细胞	hsk
威廉	ltrq
有没有人	gvgi
真难	ygxy
排污	jbvw
动心	ascx
上去了	ihd
拼接	jqjw
分之	mfgz
相声	gmrs
执政党	ptz
妇产	xbwc
看向	jmuo
杀菌	xghz
点火	itwh
法案	vhyg
被骗	pgzq
很轻	dkyb
化石	ilts
幅画	bptn
移交	mbpr
杠杆	gvgh
武当	tleb
小岛	vxew
压根	zhgk
凝结	essk
圆满成功	zvlv
客栈	awgt
成才	lejc
那股	lpko
全心全意为人民服务	scsw
盖上	miit
粉尘	kmvh
暗器	fwoo
曙光	fcet
前言	qxuy
受阻	expg
国际金融	zpst
两下	zlox
取暖	bxfe
省钱	mmlt
现存	eugi
异化	ehil
归于	abhy
长裤	ycpr
而是要	tfd
六一	pmty
有办法	gsv
声望	rspk
落户	pwqh
心想事成	cgjl
聚餐	bxix
脏腑	krkr
全厂	sqzc
蓬勃发展	hynr
撕裂	jmba
可做	jkip
城镇化	hli
向学	uozi
经脉	sbku
那对	lpxj
腾飞	knge
这么多的	wcbu
陡然	prbu
先看	qajm
不考虑	meq
世界贸易组织	unps
附加值	pwi
却可	hvjk
丑陋	ocpt
充斥	padu
漫漫	vfvf
前几年	qne
敦煌	xiwu
宽大	ahdd
解散	mjak
开封	thbj
入住	cuip
大坝	ddhd
俗话说	iuu
金融市场	stph
得手	dfjs
鸽子	aoiz
眼见	mkuj
昆仑	flil
含蓄	idhs
明朗	fkuk
国足	zebz
通向	sjuo
来华	qkil
按键	jylb
嬷嬷	xrxr
肛门	kvnm
带头人	moi
在先	ghqa
杨幂	glaf
教职工	ebv
说些什么	uric
作证	ikut
时下	fjox
必胜	cckc
网络化	nsi
慌乱	yhai
肥厚	kvzf
归结	absk
养分	mumf
身手	psjs
二元	wejy
钢管	lnna
存量	gift
费力	casl
甲醇	njdx
较早	ypfy
据我	jrjl
祖母	dgom
温水	vfzs
安娜	yaxl
下流	oxvp
前瞻	qxmm
百家	tfaq
许多国家	ubza
太差	dumv
无序	hirs
高热	xgpt
豁达	aodr
守在	ajgh
自动控制	cajq
荒漠	hpvi
我告诉你	jkui
怎样才能	kgjv
错觉	lazu
或以	loby
向量	uoft
基层组织	mrss
得下	dfox
就是那个	xfli
再让	enui
你呀	imot
喷射	oypj
帷幕	byib
想学	gmzi
低估	ipip
字样	aigm
样板	gmgz
此法	rlvh
通透	sjml
检讨	gauj
归还	abmr
价值观念	iixi
当代中国	emoz
倒闭	itnj
别以为	kbe
波澜	vgvn
世家	usaq
社会保险	diip
则应	darz
过了一会	jdti
被捕	pgjj
这所	wrzr
置入	cycu
防卫	ptpt
接力	jwsl
投稿	jomx
吃力	oesl
其实就是	maxf
含着	idmm
狂热	qept
缤纷	sasm
上万	itte
圣诞树	xug
那片	lptp
快速增长	yghy
一盏	tytl
清纯	vlsl
谋杀	uhxg
乐器	pvoo
胆碱	kftl
怪兽	yxkn
并列	qhba
上旬	itsf
分光	mfet
舍弃	apph
打完	jxaj
不慎	mbyy
从这里	iwh
军方	aytf
三资	csef
膜拜	kijt
博士生	yhc
住进	ipur
忧愁	yimw
坚硬	axtx
新歌	ndjj
顾及	zelj
为外	esbi
伙计	iwuy
总队	kopi
母乳	omei
公仆	mvii
粗暴	kgfa
科学发展观	mznx
建房	bhqt
剑法	azvh
增至	hktv
新机	ndgn
亨利	xdma
新闻界	nnn
荣幸	xghq
祖国统一	dzst
新老	ndel
谁又	uyxy
顺天	sttd
腿上	kkit
结核病	sgf
第二种	nwm
舞会	ebia
林木	ylgm
尽管如此	anxr
我们学校	jizg
天安门	tyn
新近	nddr
偏爱	iqeg
一针	tyly
神气	dfaq
电动机	fag
相逢	gmwk
小平同志	vhnh
公平竞争	mhwm
闺女	nbxn
九龙	kjgl
字体	aiig
也像	uyie
主宰	pzaw
抓狂	jrqe
撞到	jwth
村委会	gmi
反倾销	zil
购销	dsle
有效期	gpm
还行	mrdl
卷烟	newz
羞涩	movm
无水	hizs
跪在	bmgh
居多	rpbb
理论基础	eumt
中型	ovta
某种程度	hmmr
处以	wiby
赶脚	rhkh
看穿	jmat
能耐	vkti
烽烟	wwwz
报到	jpth
武艺	tlhg
代购	mdds
各不	wgmb
简要	nndx
翻炒	cnwm
嚣张	oocy
发展目标	nrmg
喷雾	oyzw
逼真	pryg
专业人员	woio
惩治	dtvv
最具	fbgm
恋情	rcyl
腐朽	rigv
粘合	kiao
防线	ptst
重金	ahsj
大水	ddzs
以後	byds
那场	lphl
圆柱	zogp
音箱	wfng
明清	fkvl
等效	nhpr
所拥有	zjg
妄想	pxgm
貂蝉	qmck
溅射	vdpj
世事	usjo
切实可行	lajd
笑出	ncvc
清风	vlnf
儿科	aemk
停滞	ixvm
史记	oxue
局域	rehl
啥子	oaiz
世界卫生组织	unps
车内	yckn
宠爱	ageg
公交车	mpy
心甘情愿	chyz
有关人员	gkio
教练员	eso
政治经济	tvsv
警官	hwau
拉链	jwly
纤细	sasn
钱财	ltdj
我们今天	jiit
翻开	cnth
宁波市	avp
清明	vlfk
收视	ywdu
熊熊	vlvl
之後	gzds
记下	ueox
中央领导	otie
送达	kddr
当个	ebiv
太晚	dufm
能及	vklj
用餐	jyix
祈求	ddzu
强硬	cotx
人与人之间	isin
灰常	gwzb
雪山	zbws
越冬	rlwe
美满	mdvh
难堪	xyhm
政企	trir
申诉	fvud
死掉	blji
传记	iwue
飞了	gedj
过客	jraw
专著	wvhe
高傲	xgif
水管	zsna
石榴	tsgm
亚运会	oai
俱进	igur
曾被	kvpg
也是如此	ufxr
村级	gjsl
工作组	vis
厨师	ztat
琉璃	epew
教书	eidp
肿块	koht
能动	vkas
花纹	hisw
全员	sqod
应酬	rzds
二十世纪	wyus
叹道	oxqc
药方	hstf
反面	zxtc
书生	dpcm
光度	etrh
不支	mbyx
三轮	csyi
心眼	cxmk
叶利钦	oml
值钱	iylt
口径	okdb
下层	oxra
水墨	zsdh
太湖	duvp
气球	aqez
老同志	enh
带出	mavc
罢工	chvg
消炎	veww
已过	eyjr
首创	qcja
圆圆	zozo
美国经济	mzsv
老太婆	edv
餐具	ixgm
真切	yglm
难听	xyod
无罪	hicb
哇靠	obkb
娘家	xuaq
可以理解	jbem
缠绕	srsl
显著提高	fhjx
怨恨	beyk
筹建	nkbh
我也觉得	juzd
爱因斯坦	ezmh
报应	jprz
却让	hvui
粘度	kirh
山林	wsyl
法国人	vzi
公共卫生	mapc
调皮	ungp
流淌	vpve
假冒伪劣	ifim
曲子	faiz
上分	itmf
密切联系	albc
光是	etft
计生	uycm
印第安	pny
防病	ptft
救治	zuvv
不客气	maa
现货	euil
船员	bnod
每天晚上	etfi
打交道	jpq
回想起	zgr
副省长	pmy
工期	vgmk
可以这么	jbwc
字眼	aimk
牛顿	qnlz
电解质	fmz
好多好多	xbxb
与会者	sie
沿海地区	vvhj
会议精神	iukd
强弱	coce
从实际出发	iapn
入场	cuhl
排序	jbrs
创始人	jxi
原生	zucm
很熟	dkxk
疫病	foft
名言	bouy
而是因为	tfze
真多	ygbb
除尘	pvvh
无误	hiuo
局域网	rhn
简陋	nnpt
唇膏	zqxk
就坐	xvii
柿子	gpiz
心里想	chg
丘陵	dqph
两口	zlok
耻辱	brzq
窗子	auiz
当机	ebgn
之色	gzmv
壁垒	rwvv
完整性	agy
只猫	omqh
父本	rfgt
头昏	otpl
精髓	klyg
星期二	fmw
妖精	xckl
转过头	yjo
幕后	ibko
插座	jari
现报	eujp
研制成功	tqlv
越想	rlgm
鬼子	uaiz
义乌	uxew
那时的	lfu
打假	jxir
一分钱	tml
有关法律	gkvd
接头	jwot
社会问题	dinf
供血	iaci
汹涌	vxvs
法语	vhuc
又与	xysy
那本	lpgt
那才	lpjc
序幕	rsib
热电	ptfi
突如其来	axmq
奈何	dnij
时间上	fni
树下	gxox
还有的	mgu
这一段	wtd
莫不	immb
扶着	jymm
菌株	hzgq
相交	gmpr
新风	ndnf
首长	qcyc
探险	japa
红尘	svvh
联系实际	bcap
长足	ycbz
这个意义上	wiwi
工作日	vif
信息网络	icns
真是的	yfu
冻结	eysk
生活环境	cveh
不要因为	mdze
健美	ibmd
没有人能	vgiv
很适合	daa
非但	bfif
防晒	ptfd
不能够	mvs
嫁人	xair
耸耸肩	iiq
二手房	wjq
整体性	giy
处事	wijo
黄牛	aeqn
车检	ycga
师弟	atkc
不谈	mbuw
借此	iarl
打牌	jxtu
抵挡	jpje
大将军	dqa
逛逛	qeqe
每亩	eopn
冲锋	eolw
妇产科	xwm
攻略	vwnw
别扭	kajo
跟我来	bjq
就是这样的	xfwu
可控	jkja
成日	lefr
告诉了	kud
后现代	kem
源源	vzvz
对白	xjub
军用	ayjy
不理想	meg
部份	woim
家在	aqgh
不一会	mti
与时俱进	sfiu
一定要有	tadg
高处	xgwi
看了一眼	jdtm
截图	ylzw
纯属	slrc
全能	sqvk
盛会	leia
轻盈	yblx
怜悯	yiyn
你自己的	iceu
大个	ddiv
不完美	mam
一方面是	tttf
有些东西	gryd
健康状况	irqe
孟子	iiiz
今天中午	itoq
争端	mbww
送回	kdzo
弄到	ehth
头大	otdd
适于	arhy
飞来	geqk
嵌入	whcu
冤枉	auge
十四大	yzd
经济政策	svtn
贬值	dciy
发挥出	njv
听不到	omt
社会责任	dimi
女婿	xnxd
误导	uoej
自个儿	cia
内置	kncy
大小姐	dvx
番薯	ckhc
好受	xiex
很近	dkdr
也叫	uyoy
上缴	itsu
几个问题	ninf
县长	gvyc
前半	qxcb
道家	qcaq
害死	akbl
响亮	ouxn
真快	ygyt
正向	truo
巨头	jrot
鸦片	txtp
遮住	rhip
见习	ujex
青蛙	lqcb
电子邮件	fiei
收录	ywbz
好几天	xnt
通红	sjsv
经验教训	szeu
警戒	hwlh
实际应用	aprj
说起来	urq
惯了	yodj
保全	iosq
女工	xnvg
刚到	nxth
缓缓地	ssh
发电机	nfg
考评	evuh
化成	ille
自力更生	csxc
年报	evjp
交友	prgx
搭建	jhbh
被逼	pgpr
在即	ghkp
种田	mont
中路	ovbw
各行各业	wdwo
黎巴嫩	mvx
尝尝	eaea
不放心	mtc
中老年	oee
放屁	twrl
古文	pgww
为名	esbo
市内	pbkn
叹口气	ooa
而活	tiva
议案	uuyg
撒谎	jauh
班车	eyyc
有味	gkoq
如期	xomk
喝着	ofmm
校门	gpnm
生快	cmyt
阴沉	pkva
名字叫	bao
放肆	twdv
水壶	zsha
不育	mbpk
彼岸	dgwz
二万	wete
有理由	gee
全社会的	sdiu
利害	maak
虚无	qohi
望远镜	pjl
纪录片	sbt
息肉	cmki
眼科	mkmk
门上	nmit
入境	cuho
首领	qcis
风范	nfpe
挑衅	jeci
忙得	ypdf
联想到	bgt
你妈的	ixu
环绕	emsl
动弹	asck
拉起	jwre
作弊	ikkw
禁不住	ymi
无意中	hwo
有勇气	gsa
美金	mdsj
深邃	vaaq
更易	xffs
熔化	wail
射出	pjvc
购房	dsqt
管理条例	newi
推崇	jywa
之城	gzhl
杯水	gmzs
两座	zlri
版面	tztc
变小	rxvx
这个国家	wiza
命名为	abe
骨质疏松	yzdg
异议	ehuu
渔船	vrbn
仅用	ixjy
高架	xgwg
还有点	mgi
各一	wgty
红火	svwh
将就	qbxv
曼谷	fcwg
过快	jryt
合作制	aiq
从新	iind
弹力	cksl
得当	dfeb
断定	kiat
径向	dbuo
这个过程	wijm
汉城	vxhl
就其	xvmq
家常	aqzb
升值	chiy
副教授	pej
无权	higx
接见	jwuj
写过	asjr
所得税	zdm
世界第一	unnt
向右	uogo
肉眼	kimk
孤儿	irae
蛋黄	drae
公共汽车	mavy
一星期	tfm
三等奖	cnq
之势	gzps
司空	etav
垂体	aaig
台独	voqc
更长	xfyc
不容忽视	masd
买单	dokf
买家	doaq
语句	ucso
外交部长	bpwy
洪涝	vavx
路由器	beo
保值	ioiy
基本要求	mgdz
血型	cita
那间	lpnf
人海	irve
唯物主义	oqpu
画出	tnvc
敏捷	eojt
学子	ziiz
转达	ywdr
上回	itzo
安妮	yaxr
成正比	ltl
害人	akir
矿泉水	tuz
科技含量	mjif
苍老	hjel
阐释	nkck
田野	nths
西游	dxvt
抢走	jjrz
没有理由	vgee
不管怎样	mnkg
随你	pgim
连个	yriv
伙伴关系	iikc
深信	vaiu
抽筋	jenk
大力推进	dsju
俺们	idin
彩排	egjb
之神	gzdf
文学作品	wzio
掠夺	jxdj
南阳	xqpf
民主政治	eptv
亮丽	xntn
门下	nmox
当地人	ehi
感官	ltau
唯独	oyqc
极好	glxi
若能	hgvk
一般情况下	tbyo
拖拉机	jjg
写到	asth
装作	qhik
民事诉讼	ejuu
买不到	dmt
冲破	eotg
否决	moet
维和	symo
不哭	mboo
显而易见	ftfu
更像	xfie
推动作用	jaij
半数	cbkx
油价	veii
敬意	howf
日本政府	fgtr
粥样	ckgm
举例	zmib
争气	mbaq
联欢	bkxf
轴线	yest
无害	hiak
刺痛	gnfs
早熟	fyxk
相貌	gmqu
自然而然	cbtb
关了	kddj
罐头	qhot
不语	mbuc
多难	bbxy
敌对	awxj
乏味	cgoq
再打	enjx
过几天	jnt
午觉	qwzu
积水	mozs
搂着	jkmm
销毁	leuv
制片	qntp
滞留	vmpm
良久	ukmu
龙马	glzm
先来	qaqk
惆怅	ynyy
根本原因	ggzz
耐火	tiwh
起居	rerp
预售	sxyo
人道主义	iqpu
俸禄	iudb
说清	ukvl
一伙	tyiw
元气	jyaq
自卫	cmpt
粗放	kgtw
肝胆	khkf
日程	frmo
那几个	lni
南山	xqws
出过	vcjr
衣裳	pyzp
再创	enja
确信	tmiu
只爱	omeg
应将	rzqb
内含	knid
文集	wwyg
非同	bfnt
几率	njps
宣扬	atjl
内疚	knfm
也不例外	umib
权重	gxah
紧凑	axeu
名气	boaq
启迪	qoer
粉色	kmmv
推到	jyth
老龄	elrz
情谊	ylua
个半小时	icvf
中流	ovvp
自以为是	cbef
男同	nsnt
浪费时间	vcfn
老汉	elvx
造纸	krsp
中国国家	ozza
出问题	vnf
台电	vofi
知足常乐	ebzp
走完	rzaj
体育运动	ipaa
芭蕾	hvhz
疑虑	leqc
生活费	cvc
共性	amyc
不缺	mbqt
心机	cxgn
中国大陆	ozdp
低水平	izh
看图	jmzw
隔热	ptpt
来生	qkcm
答案是	nyf
相依	gmip
社会主义初级阶段	dipd
能被	vkpg
价值取向	iibu
可导	jkej
恰恰是	yyf
出海	vcve
文学史	wzo
前一天	qtt
化学成分	izlm
叫嚣	oyoo
杂草	kghf
处女座	wxr
一挥	tyja
这门	wrnm
每只	eoom
男人们	nii
集聚	ygbx
适中	arov
更令	xfis
外貌	biqu
左下	gvox
矢量	esft
飞出	gevc
内心深处	kcvw
更让	xfui
好小	xivx
露天	zbtd
这副	wrpa
周密	nhac
过冬	jrwe
清仓	vljc
环卫	empt
太深	duva
相距	gmbj
株洲	gqvs
精神状态	kdqd
吐血	ohci
乌龟	ewmf
书架	dpwg
法律责任	vdmi
则要	dadx
都行	epdl
亲生	nqcm
老爷子	eri
监会	ania
海滨	veva
钙化	ltil
我厂	jlzc
楼市	gkpb
饮用水	mjz
对子	xjiz
进退	urkr
校园网	gzn
好一个	xti
没有这样	vgwg
妩媚	xhxr
外边	bisr
玩弄	ejeh
空隙	avpv
哈利	oama
消融	vetn
有眼	gkmk
倏地	iwhu
坚固	axzp
火柴	whrl
薄弱环节	pceh
成功经验	lvsz
防腐	ptri
漫天	vftd
衬衣	pjpy
名著	bohe
我们两个	jizi
神功	dfvs
元帅	jyab
摇了摇头	jdjo
鼻涕	cmvk
支承	yxdz
同级	ntsl
鼻炎	cmww
数据显示	kjfn
就近	xvdr
各个环节	wieh
咖喱	owoz
不合适	maa
嘴边	olsr
摄氏度	jpr
动车	asyc
波浪	vgvu
骗了	zqdj
哟哟	osos
有关单位	gkki
逃脱	eekk
来历	qkzs
之和	gzmo
相对应	gxr
药典	hsna
微分	fnmf
倒塌	ithf
优胜	iikc
女主人	xpi
低级	ipsl
方方面面	tttt
防灾	ptaw
高尔夫	xmy
吕布	oogb
本不	gtmb
下图	oxzw
马克思列宁主义	zpnu
本子	gtiz
机关干部	gkhw
小胖	vxkc
毒药	mohs
师妹	atxq
愣了	ycdj
摄像机	jig
现出	euvc
和睦	momh
则会	daia
圣经	xhsb
相位	gmiw
眼眸	mkmv
收受	ywex
综合国力	sazs
高中生	xoc
易学	fszi
独到	qcth
找工作	jvi
制造商	qkn
有限责任公司	gpme
摄取	jbbx
隐身	pmps
单方	kftf
阑尾	ngrq
半导体	cei
不以为然	mbeb
伸展	ifra
倒地	ithu
高调	xgun
指尖	jlvd
铁杆粉丝	lgks
题词	frue
显像	foie
第一种	ntm
张口	cyok
附表	pimq
纸巾	spbj
武侠	tliy
霎时	zwfj
法令	vhis
逐一	qrty
转播	ywjc
内需	knzt
卸妆	erqx
中俄	ovij
自信心	cic
丰盛	kfle
偷拍	iaju
替换	yyjm
架构	wggs
绝非	smbf
差不多了	mmbd
未被	qwpg
仰卧	ipjv
有梦	gkyb
资源管理	evne
力图	slzw
健康成长	irly
凡人	nuir
低了	ipdj
各县	wggv
鸡血	xeci
都受	epex
乌拉	ewjw
大中城市	dohp
公然	mvbu
本职	gtbo
坐落	iipw
美方	mdtf
勾起	svre
心慌	cxyh
南通	xqsj
赤裸裸	hpp
长生	yccm
眼花	mkhi
转录	ywbz
抽调	jeun
多种多样	bmbg
即便是	kif
没有这么	vgwc
成都市	lep
星期日	fmf
尊敬的	qhu
身心健康	pcir
真能	ygvk
很不好	dmx
典雅	natx
经济基础	svmt
热力	ptsl
讲过	uujr
域名	hlbo
地块	huht
地盘	hubi
八成	mble
灭亡	twpw
贺岁	wdwb
迎合	ppao
应该会	rui
如此之	xrg
不老	mbel
有文化	gwi
对号	xjov
较弱	ypce
硅酸	tbdv
我们这个	jiwi
端口	wwok
沉睡	vama
蒙面	xwtc
行径	dldb
那有	lpgk
共同体	ani
很自然	dcb
真够	ygso
农机	bqgn
破解	tgmj
镇上	lyit
小脑	vxkw
之二	gzwe
习惯于	eyh
温热	vfpt
不在意	mgw
只留	ompm
走后	rzko
而更	tixf
科研人员	mtio
如花	xohi
很正常	dtz
找寻	jlbj
去皮	hvgp
永安	uzya
人均收入	ihyc
涉外	vrbi
海里	vehl
百分比	tml
直达	ygdr
付诸	ijue
因为这个	zewi
三毛	csqm
动植物	agq
汲取	vlbx
坠落	pipw
倾向于	iuh
电场	fihl
一年级	tes
有什么用	gicj
姑姑	xpxp
又叫	xyoy
图画	zwtn
消瘦	vefu
美梦	mdyb
睡得着	mdm
听证	odut
前苏联	qhb
中位	oviw
恭喜发财	aknd
几秒	njmm
角逐	mjqr
收益率	yqp
比较高	lyx
不要这样	mdwg
刻骨铭心	sylc
成像	leie
全力以赴	ssbr
肉肉	kiki
十八岁	ymw
床单	rgkf
浮肿	veko
便能	ixvk
背面	kltc
电影节	ffh
调配	unde
刹车	xgyc
会面	iatc
西医	dxje
日韩	fryy
为什么呢	eico
驻地	zphu
欢快	xfyt
经济管理	svne
神啊	dfop
神州	dfsz
谈心	uwcx
他们之间	iign
疑似	leib
调用	unjy
熔炼	wawl
个案	ivyg
大肆	dddv
好让	xiui
一任	tyis
晒晒	fdfd
某一个	hti
台州	vosz
新书	nddp
一具	tygm
调速	ungo
看见的	juu
唤起	omre
心急	cxmb
死得	bldf
尤为重要	iead
护法	jqvh
青铜	lqln
同居	ntrp
钟声	lors
故宫	pwao
有变	gkrx
有功	gkvs
缝隙	swpv
没有机会	vggi
我敢	jldb
一整套	tgd
丑恶	ococ
大势	ddps
科长	mkyc
鸳鸯	bete
农用	bqjy
七一	lqty
小样	vxgm
一念	tyid
燃油	wuve
偏心	iqcx
大动	ddas
地沟	huvs
冬瓜	werg
考查	evgf
冰冻	ezey
吃上	oeit
对得起	xdr
想不起	gmr
越小	rlvx
别看	kajm
病虫害	fca
一改	tyew
主导地位	pehi
有需要	gzd
普遍性	qqy
和面	motc
大路	ddbw
怎么又	kcx
让步	uirm
企业主	iop
指纹	jlsw
娶了	bxdj
末期	qmmk
外露	bizb
杰作	gtik
瑜伽	eaiw
得益于	dqh
又因	xyzd
人民生活水平	iech
温差	vfmv
选票	qadn
面板	tcgz
感想	ltgm
影响下	foo
这样下去	wgoh
清淡	vlvw
海贼王	vde
魔术师	rga
装逼	qhpr
老板娘	egx
亮度	xnrh
逾期	axmk
年期	evmk
贴着	dimm
红十字	sya
从哪里	ioh
巡视	srdu
世界纪录	unsb
乔石	cdts
此情	rlyl
足联	bzbk
上书	itdp
春耕	ufqu
上大学	idz
大纲	ddsn
故作	pwik
不一定要	mtad
不会吧	mio
很准	dkey
公共场所	mahz
合体	aoig
分子量	mif
荔枝	hsgy
瞧着	mymm
情妇	ylxb
施主	tupz
听课	oduf
民政部	etw
离退休	wki
警卫	hwpt
闭着	njmm
挂上	jbit
我们一直	jity
后劲	kobv
直奔	ygdy
高峰期	xwm
宇航	ahbp
法拉	vhjw
短款	ethn
卫生院	pcp
禁区	ynjx
警觉	hwzu
疑难	lexy
开拓创新	tjjn
可不能	jmv
或用	lojy
相联	gmbk
不负责任	mimi
齐齐	wawa
互为	toes
必修	cciw
播报	jcjp
几千年	nae
推导	jyej
这些年来	wreq
福特	dpqh
对劲	xjbv
一语	tyuc
尽是	aeft
要害	dxak
组件	sgiq
门课	nmuf
看错	jmla
香港特别行政区	mvqj
来年	qkev
螺丝	cnss
闭嘴	njol
晋升	ofch
独生子	qci
海岛	veew
我们总是	jikf
不学	mbzi
锐利	lkma
数万	kxte
怪你	yxim
画像	tnie
要能	dxvk
注意安全	vwys
母女	omxn
阀门	ninm
一条龙	twg
原创	zuja
时有发生	fgnc
作对	ikxj
喷出	oyvc
风波	nfvg
歌迷	jjkr
网格	nxgw
下人	oxir
下意识	owu
你懂得	iyd
风机	nfgn
为时	esfj
睁眼	mmmk
既然是	kbf
党政机关	ztgk
翻滚	cnvp
奔向	dyuo
过热	jrpt
这倒	writ
摄像头	jio
密切关系	alkc
眨眼	mcmk
老天爷	etr
奖惩	qbdt
汉奸	vxxh
手电	jsfi
厚重	zfah
呼啸	ocob
没有关系	vgkc
岸边	wzsr
霉菌	zehz
吴邦国	okz
穿衣服	apk
变幻	rxse
小鸡	vxxe
失意	eswf
居家	rpaq
回流	zovp
信件	iuiq
一看到	tjt
收养	ywmu
车窗	ycau
想方设法	gtuv
公元前	mjq
谁让	uyui
围绕着	zsm
师专	atwv
坚决反对	aezx
大雾	ddzw
可逆	jkkn
从理论上	ieui
很对	dkxj
都没有了	evgd
一战	tyil
因为这样	zewg
瞧见	myuj
受损	exjo
民族精神	etkd
先导	qaej
衣衫	pypq
谁叫	uyoy
舒畅	apfv
拟定	jbat
所获	zrhq
爱爱	egeg
办公桌	smi
定型	atta
卖掉	ydji
道士	qchs
刀子	mdiz
远比	jrlb
之感	gzlt
同龄	ntrz
一户	tyqh
国家规定	zaya
不平等	mhn
镇压	lyzh
火光	whet
年夜饭	epm
精油	klve
恶搞	ocjx
好汉	xivx
下一次	ote
胡乱	pkai
骤然	zxbu
油腻	vekl
晶粒	ffkw
施工单位	tvki
每小时	evf
近千	draq
跳水	bezs
你他妈	iix
高密	xgac
遗体	crig
生产关系	cwkc
唱得	ofdf
扔掉	jlji
泪奔	vmdy
成因	lezd
人前	irqx
调查显示	ugfn
现成	eule
人命	irao
内陆	knph
到处都是	twef
相关部门	gkwn
第三天	nct
段话	doua
市场价格	phig
拉伸	jwif
中行	ovdl
沙拉	vmjw
初衷	pmpo
从早	iify
滔滔	veve
用意	jywf
关照	kdfm
无暇	hifr
晚间	fmnf
满地	vhhu
鉴赏	anzd
大熊	ddvl
总有那么	kglc
不可能有	mjvg
红茶	svhi
形式主义	tlpu
室友	atgx
随处	pgwi
重点建设	aibu
次要	efdx
副院长	ppy
拦住	jqip
那么容易	lcaf
工作原理	vize
腰酸	kddv
这么简单	wcnk
买不起	dmr
保障体系	ipic
输尿管	yrn
另据	kljr
高二	xgwe
渊源	vavz
泥沙	vrvm
辨别	wyka
迅猛发展	gqnr
色情	mvyl
道上	qcit
曾经在	ksg
透彻	mldl
容许	awuq
到头来	toq
太监	duan
不失为	mee
之争	gzmb
抗压	jpzh
大吃一惊	doty
痛恨	fsyk
月薪	kyhn
无非是	hbf
人肉	irki
传给	iwsa
毁掉	uvji
什么原因	iczz
送入	kdcu
笔记本电脑	nugk
尤以	iuby
变相	rxgm
两台	zlvo
颤动	ptas
道具	qcgm
有为	gkes
衰减	poel
求知	zueo
大院	ddpa
救救	zuzu
一件事情	tijy
小妞	vxxo
有车	gkyc
政治问题	tvnf
年仅	evix
积蓄	mohs
腰间	kdnf
情操	yljo
注意事项	vwjv
住处	ipwi
自然条件	cbwi
翩翩	qiqi
能像	vkie
非常重视	bzad
财运	djar
聘任	beis
扩充	jrpa
女童	xnwh
何尝	ijea
很紧	dkax
呼吸困难	oozx
一顶	tyxt
个位	iviw
毛竹	qmnz
胜任	kcis
农行	bqdl
会议室	iua
移栽	mbyl
大喝	ddof
中非	ovbf
完成任务	aliw
蓝图	hazw
宝钢	aeln
异样	ehgm
侵占	ibiz
还有些	mgr
这番话	wcu
法宝	vhae
潜意识	vwu
没这么	vwc
组队	sgpi
理化	ehil
曾经是	ksf
急速	mbgo
压低	zhip
红颜	svwc
家教	aqei
死因	blzd
同仁	ntiw
客流	awvp
甲级	njsl
飞过	gejr
只狗	omqs
贪心	idcx
两极	zlgl
自然保护区	cbij
承受能力	devs
知识结构	eusg
缺钱	qtlt
实干	aohg
倒退	itkr
雷人	znir
王者	ewez
傲慢	ifyf
新意	ndwf
重来	ahqk
生活上	cvi
买入	docu
也不同	umn
自己人	cei
三岁	cswb
能手	vkjs
中秋	ovmw
年薪	evhn
冷藏	eihl
报废	jprn
病症	ftft
木质	gmzy
翻过	cnjr
衣物	pyqs
墨迹	dhrr
个例	ivib
远近	jrdr
振作	jzik
牧师	qwat
摇着	jemm
看不见的	jmuu
机密	gnac
狭隘	qypq
中式	ovlv
胜负	kcif
农科院	bmp
所拥有的	zjgu
很严重	doa
产区	wcjx
连着	yrmm
救国	zuze
配偶	dein
飞行员	gdo
一审	tyaf
脸孔	kaii
心肌梗死	ckgb
岛屿	ewws
牧草	qwhf
取材	bxgj
清香	vlmf
出处	vcwi
配音	dewf
甘露	htzb
奔走	dyrz
发火	nfwh
自然醒	cbd
转轨	ywyk
散发出	anv
伦理学	iez
骨子	ygiz
天线	tdst
无毒	himo
伊利	ibma
陪她	pwxu
奉行	uhdl
峡谷	wywg
作曲	ikfa
规律性	ydy
时不时	fmf
耗费	qqca
拘留	jspm
孔隙	iipv
纪实	seao
脑海中	kvo
俘虏	ieqs
幽幽	wsws
好地方	xht
社长	dhyc
师姐	atxg
高地	xghu
最前	fbqx
工作经验	visz
便把	ixjv
油漆	vevg
育苗	pkhn
这双	wrxx
学风	zinf
蕴藏	hshl
最根本的	fggu
绝对不能	sxmv
写照	asfm
报告会	jki
不畏	mbnq
有吗	gkoz
招商引资	jnce
恍惚	yeys
一条路	twb
中年人	oei
骑兵	zddm
作过	ikjr
搞错	jxla
团圆	zjzo
有待于	gdh
既往	kidp
行星	dlfc
党支部书记	zywu
人性化	iyi
玩耍	ejti
用具	jygm
转会	ywia
皮草	gphf
我们这里	jiwh
伊始	ibxv
催眠	iwme
印度尼西亚	prro
钟表	lomq
人像	irie
赐予	dfsx
急得	mbdf
订票	uxdn
送进	kdur
生活习惯	cvey
联谊	bkua
中兴	ovzm
工作站	viw
本省	gtmm
哇哦	oboj
鼻咽	cmoz
菜刀	hemd
定下	atox
论断	uiki
满足于	vbh
不可忽视	mjsd
不能接受	mvje
拍出	juvc
中止	ovrz
气孔	aqii
带去	mahv
中央政府	ottr
学习成绩	zels
一束	tygo
有光	gket
冷清	eivl
欢迎你	xpi
发信	nfiu
不得已	mde
萌芽	hfht
二氧化碳	wait
乌龙	ewgl
这封	wrbj
再找	enjl
气压	aqzh
太白	duub
老伴	elic
交大	prdd
组图	sgzw
莫大	imdd
就能够	xvs
在世界上	guni
攀登	ggbt
摒弃	jrph
疏忽	drsd
出在	vcgh
有些地方	grht
调到	unth
据不完全统计	jmau
鱼类	rykd
微粒	fnkw
退缩	krsa
胆道	kfqc
力矩	slej
真气	ygaq
三角形	cmt
上肢	itky
既定	kiat
无常	hizb
下沉	oxva
南宋	xqag
动听	asod
我们希望	jixp
收下	ywox
清白	vlub
女式	xnlv
明天早上	ftfi
听出	odvc
做一些	itr
袖子	peiz
大宗	ddan
大娘	ddxu
但已	ifey
肌腱	knkb
户籍	qhnq
低迷	ipkr
爆竹	wfnz
勇士	sjhs
战国	ilze
游击队	vhp
福尔摩斯	dmrm
种群	mobc
未到	qwth
第一眼	ntm
水力	zssl
快走	ytrz
详尽	umae
如上	xoit
匈牙利	stm
四分之	zmg
城墙	hlhy
最令	fbis
决不是	emf
相约	gmss
美腿	mdkk
即以	kpby
掌柜	zjgj
窝在	aogh
后是	koft
有节	gkhp
最让	fbui
爬到	rvth
飘逸	dnur
细分	snmf
公鸡	mvxe
忏悔	yaye
荒谬	hpub
飞奔	gedy
声势	rsps
科教兴国	mezz
派送	vzkd
第三者	nce
产业结构调整	wosg
没发现	vne
体外	igbi
第一届	ntr
脱了	kkdj
史上	oxit
偏僻	iqir
各民族	wet
着车	mmyc
催促	iwib
幸福快乐	hdyp
元月	jyky
连年	yrev
止咳	rzos
总值	koiy
足够了	bsd
下垂	oxaa
电视上	fdi
马蹄	zmbw
伤势	ieps
微波炉	fvw
向内	uokn
闽南	ncxq
硬币	txcb
主旋律	ptd
电大	fidd
楼盘	gkbi
一步一步	trtr
敢想	dbgm
一塌糊涂	thkv
动工	asvg
汉代	vxmd
何苦	ijhp
不要以为	mdbe
庄稼	rhma
情结	ylsk
闯进	nzur
电影票	ffd
不忍心	mmc
享用	xijy
链条	lywg
弱智	ceeo
老干部	ehw
不包括	msj
压倒	zhit
预热	sxpt
订婚	uxxp
真让	ygui
医疗费	jfc
包膜	sbki
小鱼	vxry
国家教委	zaem
远程教育	jmep
致密	thac
单机游戏	kgvx
忧心	yicx
智利	eoma
做出的	ivu
有什么关系	gicc
为政	estr
肯定有	rag
外援	bije
夸大	dwdd
凉了	exdj
小船	vxbn
成真	leyg
多数人	bki
她给	xusa
于世	hyus
旁观	wtxu
德国人	dzi
正交	trpr
侵略者	ine
捂住	jcip
广播电视	rjfd
医疗卫生	jfpc
百元	tfjy
仅次	ixef
抢手	jjjs
左上	gvit
新旧	ndvf
人见	iruj
匹马	jazm
粥样硬化	cgti
制度创新	qrjn
这样可以	wgjb
满腔	vhka
熄灭	wctw
滴水	vnzs
环境问题	ehnf
超强	rmco
对于一个	xhti
沿江	vnvv
出钱	vclt
痴迷	fekr
一天天	ttt
上哪	itol
这颗	wrfg
上树	itgx
迷糊	krkp
红肿	svko
虹桥	cvgc
相隔	gmpt
推算	jynm
词典	uena
红烧	svwl
中枢神经	ogds
水下	zsox
连夜	yrpi
不会因为	mize
既没	kivo
集散	ygak
总分	komf
水产品	zwo
新年好	nex
通通	sjsj
开端	thww
狠心	qkcx
选题	qafr
千古	aqpg
掌心	zjcx
藏族	hlte
常常是	zzf
整形	gwth
伟大领袖	idip
果园	fgzj
好心人	xci
驱逐	zjqr
一年前	teq
琥珀	eqeu
梳理	gpeh
出汗	vcvh
生日礼物	cfdq
变大	rxdd
大家好	dax
繁育	ewpk
离合	wzao
较轻	ypyb
同是	ntft
一心一意	tctw
高空	xgav
两根	zlgk
兵力	dmsl
正反	trzx
更年	xfev
立交	wlpr
曾对	kvxj
这个城市	wihp
渺小	vmvx
南美	xqmd
绒毛	slqm
儒学	izzi
醋酸	dadv
儿时	aefj
后门	konm
铺设	ljuo
更为重要	xead
舟山	bzws
湿了	vfdj
米粉	kmkm
低着	ipmm
混杂	vfkg
开盘	thbi
变压	rxzh
不思	mbnc
仙女	iwxn
你说什么	iuic
收看	ywjm
赶走	rhrz
才来	jcqk
集成电路	ylfb
质问	zyno
也以	uyby
做主	ippz
个部分	iwm
低压	ipzh
焚烧	ywwl
住所	ipzr
我党	jlza
睁开眼睛	mtmm
南朝	xqyy
配对	dexj
副会长	piy
基础知识	mteu
一直都是	tyef
哪样	olgm
多种经营	bmsx
劣质	mszy
效用	prjy
胸腺	ksku
撞上	jwit
如前	xoqx
万事如意	tjxw
站出来	wvq
全球经济	sesv
自是	cmft
岁时	wbfj
我们发现	jine
胁迫	ksur
任由	isey
外省	bimm
真像	ygie
只可惜	ojy
历史学	zoz
另一位	kti
践踏	btbz
五万	cwte
米高	kmxg
那么久	lcm
嗡嗡	omom
流量计	vfu
柴油机	rvg
能起	vkre
含糊	idkp
双休	xxig
不放弃	mtp
恒温	ytvf
我们俩	jii
栏杆	gqgh
盆地	mihu
并被	qhpg
一季度	tmr
全套	sqdd
心肺	cxkt
探望	japk
文档	wwge
十佳	ysib
批示	jlns
长叹	ycox
法律制度	vdqr
安乐	yapv
乳化	eiil
你们俩	iii
演戏	vaxl
也许有	uug
用处	jywi
灭菌	twhz
堵住	heip
好热	xipt
推移	jymb
深渊	vava
足协	bzys
银色	lkmv
三八	csmb
投入到	jct
紧闭	axnj
特派	qhvz
沉寂	vaav
赚到	dqth
你怎么了	ikcd
洛克	vwpa
说到底	utr
纺织品	sso
中小型	ovt
劣势	msps
后继	kosk
民主集中	epyo
贯通	odsj
半决赛	cea
话音	uawf
五脏	cwkr
又怎样	xkg
带点	mait
黑色素	dmm
新经济	nsv
帆布	bngb
尖端	vdww
寻觅	bjeu
进驻	urzp
这里面	wht
调查报告	ugjk
社会关系	dikc
散布	akgb
石蜡	tsca
处死	wibl
间谍	nfuu
叠加	xxwj
一愣	tyyc
元代	jymd
虚心	qocx
装卸	qher
任何事情	iijy
盛宴	leaf
吸水	olzs
却把	hvjv
心安	cxya
力作	slik
那座	lpri
跑得	bsdf
站点	wiit
虹口	cvok
华为	iles
老弟	elkc
搬运	jbar
死活	blva
守卫	ajpt
擦干	jahg
毒副作用	mpij
超薄	rmpj
收费标准	ycge
特别好	qkx
参军	vday
发展壮大	nrqd
不拘	mbjs
才能够	jvs
小腹	vxke
出错	vcla
无谓	hiun
道长	qcyc
思想家	nga
童装	whqh
几只	njom
作废	ikrn
提炼	jfwl
不告诉	mku
斗地主	khp
了些什么	dric
飞速发展	ggnr
文化艺术	wihg
商品化	noi
稳妥	mmex
当地政府	ehtr
起火	rewh
俗称	iwmm
体型	igta
再也不会	eumi
烧成	wlle
锅里	lohl
很不错的	dmlu
耳目	bemm
决战	etil
有全	gksq
中游	ovvt
破损	tgjo
八路	mbbw
荆州	hhsz
课上	ufit
奥委会	umi
日内瓦	fkf
差一点	mti
发展规律	nryd
又再	xyen
可以肯定	jbra
淡薄	vwpj
晚点	fmit
一个孩子	tiii
有中国特色的社会主义	gozu
仅次于	ieh
起动	reas
强烈要求	cbdz
改观	ewxu
天山	tdws
烟气	wzaq
棋手	gmjs
不会的	miu
大兴	ddzm
万恶	teoc
物质基础	qzmt
照耀	fmea
特许	qhuq
由来	eyqk
身体素质	pimz
授粉	jekm
平息	hkcm
幼虫	sscc
防汛	ptvg
诗中	uhov
银行贷款	ldmh
人民军	iea
不可或缺	mjlq
校舍	gpap
各种不同	wmmn
恶梦	ocyb
中南海	oxv
旺旺	fefe
不接受	mje
分清	mfvl
突然想到	abgt
晚稻	fmme
眸子	mviz
独裁	qcyl
听见了	oud
咋就	okxv
笔钱	nqlt
一直觉得	tyzd
沉声	vars
均较	hsyp
得力	dfsl
飞到	geth
灾民	awel
正太	trdu
座山	riws
工业发展	vonr
科学管理	mzne
尽心	aecx
经济特区	svqj
把门	jvnm
公文	mvww
纪念日	sif
牵动	daas
可按	jkjy
拱手	jajs
将至	qbtv
塞进	auur
客房	awqt
不是没有	mfvg
天数	tdkx
寓意	anwf
炎热	wwpt
磨削	ryek
并不意味着	qmwm
成千上万	lait
踪影	bafv
妇幼	xbss
稀罕	mxah
多处	bbwi
让人们	uii
噗哈哈	ooo
功劳	vsxs
勾搭	svjh
哀伤	poie
政委	trmx
气喘	aqow
许许多多	uubb
一个民族	tiet
惊叫	yxoy
没有错	vgl
买好	doxi
已接	eyjw
昨天上午	ftiq
顶端	xtww
污泥	vwvr
听从	odii
外延	bicr
应答	rzna
入门	cunm
赖以	goby
痴情	feyl
忽地	sdhu
忠告	ovkg
日照	frfm
摘下	jnox
冒充	fmpa
渲染	vavk
以北	bykl
胸围	kszw
不对称	mxm
沉醉	vadp
修长	iwyc
孔明	iifk
计划经济体制	ulsq
再造	enkr
舰队	bupi
征地	dthu
板材	gzgj
是么	ftcv
眼界	mkni
感伤	ltie
供货	iail
星人	fcir
次之	efgz
高分子	xmi
一定能够	tavs
整体上	gii
按压	jyzh
陆军	phay
照着	fmmm
交通安全	psys
遗弃	crph
经济生活	svcv
它以	alby
联接	bkjw
花期	himk
读物	uyqs
更爱	xfeg
神志	dfhc
有志	gkhc
马里	zmhl
唱着	ofmm
侥幸	ilhq
通路	sjbw
插秧	jamt
薪水	hnzs
说服力	uks
惹人	hgir
焕发	wmnf
手感	jslt
源自	vzcm
风靡	nfry
荷叶	hioy
乌鸦	ewtx
蹲下	bqox
是什么样的	ficu
胸脯	kskj
何方	ijtf
愚昧	nnfq
启用	qojy
补血	pici
轻蔑	ybhc
孝顺	eist
书上	dpit
单产	kfwc
调剂	unwa
绝缘	smso
繁琐	ewee
衬托	pjjc
利好	maxi
宜昌	agff
西服	dxkp
接你	jwim
视网膜	dnk
原定	zuat
名优	boii
就知道了	xeqd
今天我们	itji
但未	ifqw
没变	vorx
后患	kooo
借钱	ialt
真正意义	ytwu
那点	lpit
发展空间	nran
本应	gtrz
多孔	bbii
狡猾	qpqy
减慢	elyf
跟谁	bkuy
开得	thdf
股民	koel
再睡	enma
爱说	eguk
座椅	rigd
散落	akpw
会儿	iaae
一无所有	thzg
点子	itiz
不简单	mnk
晴朗	fluk
人民解放	iemt
狗屎	qsrk
中介机构	oigg
检修	gaiw
交纳	prsk
照料	fmkk
拿手	aojs
摧残	jwbt
管理经验	nesz
废墟	rnhq
撤离	jpwz
有资格	geg
装满	qhvh
见报	ujjp
指针	jlly
台湾问题	vvnf
青衣	lqpy
肥皂	kvul
味精	oqkl
后背	kokl
技术含量	jgif
新农村	nbg
前卫	qxpt
法典	vhna
更严	xfoc
老将	elqb
加密	wjac
他们俩	iii
配有	degk
切身利益	lpmq
问过	nojr
截然不同	ybmn
它为	ales
接班	jwey
低低	ipip
开裂	thba
医治	jevv
全国各族人民	szwe
精湛	klvm
灾情	awyl
亲热	nqpt
大嫂	ddxu
鼻腔	cmka
也都是	uef
长乐	ycpv
督导	ixej
头等	otnh
一望	typk
明晰	fkfg
也是我们	ufji
团员	zjod
京师	xvat
一个城市	tihp
讶异	uteh
白兔	ubut
装出	qhvc
逼人	prir
而设	tiuo
好样	xigm
血红蛋白	csdu
世界银行	unld
出入境	vch
就学	xvzi
双边关系	xskc
瞪大	mbdd
湛江	vmvv
诞辰	uczq
断奶	kixl
四人帮	zik
基因型	mzt
总不能	kmv
联结	bksk
外籍	binq
逆境	knho
兮兮	mvmv
喝下	ofox
特约	qhss
风声	nfrs
注意身体	vwpi
连日来	yfq
基本功	mgv
挖出	javc
编排	sqjb
一部分人	twmi
飞起	gere
一击	tyhz
专访	wvut
磨练	rysl
哪去	olhv
仍能	ilvk
低谷	ipwg
很烦	dkwt
掌上	zjit
光大	etdd
胡椒	pkgi
飞舞	geeb
根部	gkwo
很认真	duy
投保	joio
冷风	einf
小块	vxht
均由	hsey
之歌	gzjj
查清	gfvl
这种事情	wmjy
流派	vpvz
情书	yldp
陪他	pwiu
多少个	bmi
有句	gkso
很久很久	dmdm
眩晕	msfa
移到	mbth
被害人	pai
黄连	aeyr
问卷调查	nnug
脸皮	kagp
料酒	kkvd
察看	abjm
解体	mjig
全都是	sef
糜烂	rywq
霸权	zcgx
活活	vava
建设性	buy
棉被	gupg
放得	twdf
劳模	xsgi
习惯性	eyy
多加	bbwj
醉酒	dpvd
社论	dhui
摩尔	rymv
存心	gicx
凌云	ehay
便要	ixdx
投入使用	jcij
耶路撒冷	bbje
路灯	bwwx
高效率	xpp
国家政治	zatv
要钱	dxlt
闯入	nzcu
鼓吹	kqof
可想而知	jgte
集训	ygus
最差	fbmv
加州	wjsz
前提是	qjf
真的没有	yuvg
勘查	migf
社会性	diy
一秒钟	tml
试管	ulna
亦无	ryhi
转机	ywgn
催化剂	iiw
返还	zxmr
募集	isyg
苏丹	hsnp
两声	zlrs
战利品	imo
著作权	hig
不外	mbbi
以太网	bdn
冲到	eoth
不发达	mnd
几万	njte
优惠券	ihn
品系	oocs
波斯	vgmd
静好	lmxi
配比	delb
废除	rnpv
行政区	dtj
通则	sjda
血气	ciaq
值得一提	idtj
白话	ubua
圣母	xhom
哈萨克	ohp
科委	mkmx
取舍	bxap
养殖业	mbo
动画片	att
而立	tiwl
那副	lppa
切忌	lmec
角质	mjzy
技术培训	jghu
修正主义	itpu
低产	ipwc
对过	xjjr
探针	jaly
牲畜	qcsn
刚一	nxty
中美关系	omkc
电厂	fizc
皱起	mbre
游乐	vtpv
录用	bzjy
紧贴	axdi
这个可以有	wijg
更没有	xvg
肇事	qwjo
关头	kdot
私奔	mvdy
烟火	wzwh
之名	gzbo
积极主动	mgpa
打通	jxsj
大范围	dpz
私营经济	mxsv
口音	okwf
成语	leuc
湖人	vpir
一株	tygq
之苦	gzhp
第一年	nte
工业总产值	voki
马铃薯	zlh
指头	jlot
受影响	efo
贫富	mdap
林地	ylhu
腰椎间盘	kgnb
越不	rlmb
沪深	vqva
轻功	ybvs
大难	ddxy
较之	ypgz
分不开	mmt
不玩	mbej
见鬼	ujua
转而	ywti
门类	nmkd
平平安安	hhyy
计算机网络	ungs
偶然的	ibu
打字	jxai
顶尖	xtvd
好厉害	xza
盲人	pmir
融为	tnes
行贿	dldg
明目	fkmm
他告诉	iku
就向	xvuo
可以达到	jbdt
拌匀	jcse
原产	zuwc
不低于	mih
正版	trtz
才把	jcjv
参与者	vse
警车	hwyc
闲着	ngmm
连声	yrrs
瞎子	maiz
民主集中制	epyq
出游	vcvt
冷暖	eife
活到	vath
议事日程	ujfm
茉莉	hqhm
老实说	eau
累及	nslj
草草	hfhf
向北	uokl
之最	gzfb
稻田	ment
琼脂	exkl
调侃	unio
婚前	xpqx
赶忙	rhyp
落了	pwdj
被偷	pgia
有她	gkxu
纵容	siaw
组织上	ssi
双鞋	xxcb
黑影	dhfv
你告诉	iku
他是一个	ifti
宏大	agdd
漂浮	vdve
敬佩	hoin
深水	vazs
康德	rbdy
紧要	axdx
读完	uyaj
眼睑	mkma
入股	cuko
商用	nsjy
剔除	fdpv
迈向	teuo
夹克	ykpa
血尿	cirz
这股	wrko
党章	zaoz
全镇	sqly
竖起	axre
框图	gjzw
沉静	valm
穿出	atvc
方圆	tfzo
铁水	lezs
一票	tydn
湖水	vpzs
中枪	ovgj
自己动手	ceaj
重新开始	antx
生孩子	cii
村长	gjyc
就曾	xvkv
录制	bzqn
棉袄	gupc
网状	nxqd
可能要	jvd
信息量	icf
着色	mmmv
装机	qhgn
简讯	nnug
市场占有率	phip
受累	exns
陈良宇	pua
讲道	uuqc
别致	kath
有的地方	guht
注释	vpck
三楼	csgk
所生	zrcm
真谛	yguw
低语	ipuc
微不足道	fmbq
剧团	rpzj
很多年	dbe
尽可能地	ajvh
许多事	ubj
大早	ddfy
开动	thas
累得	nsdf
立冬	wlwe
布朗	gbuk
新天地	nth
网络技术	nsjg
监督机制	aigq
减低	elip
求生	zucm
没空	voav
他们没有	iivg
淬火	vpwh
相比之下	glgo
不散	mbak
香港回归	mvza
之理	gzeh
射手座	pjr
灯泡	wxvs
愕然	yobu
透出	mlvc
来点	qkit
高祖	xgdg
和谐社会	mudi
入库	cury
灌输	vhya
我们不是	jimf
这种东西	wmyd
临时工	afv
发亮	nfxn
紧缺	axqt
剧目	rpmm
看到的是	jtuf
如能	xovk
顺之者昌	sgef
未得	qwdf
脱贫致富	kmta
中草药	ohh
大河	ddvj
工艺流程	vhvm
学习者	zee
光顾	etze
朝气	yyaq
征文	dtww
读懂	uyyh
对号入座	xocr
干事	hgjo
外卖	biyd
李洪志	gvh
兔毛	utqm
三方面	ctt
声调	rsun
世界范围	unpz
妒忌	xqec
大度	ddrh
覆盖面	dmt
惟有	yygk
裸露	pfzb
落脚	pwkh
采矿	egtr
下台	oxvo
有加	gkwj
重点项目	aivm
住着	ipmm
富豪	apxq
才有可能	jgjv
知心	eocx
仍以	ilby
爱恋	egrc
五毛	cwqm
通关	sjkd
教员	eiod
废品	rnoo
桃子	geiz
人儿	irae
那天晚上	ltfi
病床	ftrg
新教	ndei
大股	ddko
洗衣服	vpk
嘲讽	oyun
贴上	diit
可以吗	jbo
小燕子	vhi
螺纹	cnsw
保镖	iold
真的可以	yujb
项目管理	vmne
科威特	mlq
融洽	tnva
可视	jkdu
颈椎病	bgf
滴注	vnvp
无为	hies
加载	wjyl
堂堂	zhzh
举足轻重	zbya
纵观	sixu
醒过	dfjr
也不行	umd
中信	oviu
量大	ftdd
乐曲	pvfa
清清楚楚	vvyy
不好了	mxd
吃下	oeox
自带	cmma
井下	ujox
地理位置	heic
零星	zifc
被困	pgzg
尝到	eath
减缓	else
党派	zavz
退火	krwh
美中	mdov
故而	pwti
石板	tsgz
房室	qtat
峰会	wwia
结构性	sgy
帆船	bnbn
高速发展	xgnr
留念	pmid
诚心	ulcx
心生	cxcm
溢出	vqvc
身前	psqx
放声	twrs
透着	mlmm
发展变化	nrri
广度	rgrh
听懂	odyh
我是说	jfu
毕业于	loh
这可能是	wjvf
看谁	jmuy
必要条件	cdwi
小脚	vxkh
学界	zini
喊了	oldj
厚道	zfqc
咋办	oksm
布丁	gbxd
严寒	ocau
应运	rzar
自语	cmuc
城关	hlkd
当官	ebau
领导集体	ieyi
主子	pziz
稳重	mmah
每秒	eomm
宝玉	aeeu
自责	cmmd
偷偷地	iih
文化传统	wiis
假发	irnf
怒吼	xxoi
伸长	ifyc
聘用	bejy
前两天	qzt
腿部	kkwo
骚动	zxas
地中海	hov
谁看	uyjm
蝎子	cfiz
严格要求	ogdz
丰产	kfwc
化痰	ilfw
周期性	nmy
晃动	feas
气虚	aqqo
分段	mfdo
过低	jrip
韩国队	yzp
沿岸	vnwz
满身	vhps
表姐	mqxg
女人们	xii
不约而同	mstn
如火	xowh
当过	ebjr
吞吐量	tof
会考	iaev
手艺	jshg
苏格兰	hgq
辛亥	wxsh
书记处	duw
顶上	xtit
试了	uldj
钦佩	lfin
稿子	mxiz
两倍	zliw
最热	fbpt
长高	ycxg
高超	xgrm
更低	xfip
暨南	kixq
点钱	itlt
就在这时	xgwf
忙于	yphy
晕倒	fait
骨子里	yih
鼻孔	cmii
美男	mdns
男篮	nsna
宣誓	atjd
学生会	zci
自助餐	cgi
双肩	xxqk
本命年	gae
天文学	twz
听来	odqk
本条	gtwg
质检	zyga
破旧	tgvf
观摩	xury
药效	hspr
射线	pjst
适合的	aau
可操作性	jjiy
新进	ndur
出世	vcus
收音	ywwf
东道	yvqc
尼泊尔	rvm
洞口	vnok
朗诵	ukus
眼袋	mkmp
字形	aith
来电话	qfu
更无	xfhi
腾出	knvc
没有找到	vgjt
译文	uxww
这台	wrvo
动情	asyl
靓女	luxn
惊悚	yxyg
我们相信	jigi
捐助	jogs
回合	zoao
穴道	axqc
如若	xohg
乘机	mkgn
装载	qhyl
地沟油	hvv
好恶	xioc
萧山	hbws
南下	xqox
谁给	uysa
抚养	jhmu
以示	byns
绕过	sljr
消逝	vejd
御史	deox
宾客	adaw
金子	sjiz
雨中	zyov
节制	hpqn
一个劲	tib
包扎	sbji
建立起来	bwrq
下个月	oik
得体	dfig
不对劲	mxb
气泡	aqvs
好成绩	xls
基本理论	mgeu
最简单的	fnku
到场	thhl
海棠	vezg
小青	vxlq
摘除	jnpv
朱熹	qzkq
一张纸	tcs
识字	uoai
法制化	vqi
虚构	qogs
大案	ddyg
让给	uisa
放慢	twyf
一年一度	tetr
只脚	omkh
订货	uxil
超声波	rrv
奠基	qdmh
万千	teaq
天天向上	ttui
燕麦	homw
社会制度	diqr
破除	tgpv
淡漠	vwvi
金龙	sjgl
韵味	wfoq
防火墙	pwh
慌忙	yhyp
安神	yadf
建制	bhqn
镶嵌	lpwh
上船	itbn
轮船	yibn
张嘴	cyol
泛起	vcre
实心	aocx
前头	qxot
车臣	ycjv
密切配合	alda
那辆	lpyz
光临	etan
它使	alix
逼得	prdf
周总理	nke
道德规范	qdyp
动向	asuo
反向	zxuo
精液	klvp
出演	vcva
伟人	iwir
才使	jcix
择优	jxii
重要地位	adhi
恩爱	zdeg
工作方法	vitv
秘鲁	mcrf
欠佳	fqib
没找到	vjt
勤俭	hmia
不舍得	mad
猜到	qlth
悬念	gvid
什么名字	icba
粗大	kgdd
探亲	janq
歪歪	mtmt
见状	ujqd
看过来	jjq
疾患	feoo
加权	wjgx
台胞	voks
均已	hsey
不重视	mad
灌木	vhgm
空地	avhu
撤出	jpvc
什么样的人	icgi
体委	igmx
快车	ytyc
怪怪	yxyx
贴身	dips
治本	vvgt
祖宗	dgan
江北	vvkl
宿主	aipz
电灯	fiwx
留了	pmdj
办公楼	smg
搏斗	jjkd
江水	vvzs
装潢	qhva
少不了	mmd
昏昏	plpl
眷恋	nmrc
打火	jxwh
买方	dotf
一堂	tyzh
转告	ywkg
课时	uffj
摆设	jcuo
想不通	gms
重要措施	adjt
璀璨	ewex
工艺品	vho
专业课	wou
钻孔	liii
赚了	dqdj
几声	njrs
中心城市	ochp
受精	exkl
原因在于	zzgh
教育工作者	epve
长治	ycvv
情意	ylwf
那般	lpbo
很快地	dyh
绵绵	susu
长年	ycev
那么难	lcx
关键技术	kljg
科索沃	myv
正是由于	tfeh
高铁	xgle
可好	jkxi
拉力	jwsl
民进	elur
废弃物	rpq
辨认	wyui
政府官员	trao
亲朋好友	nkxg
交通工具	psvg
稻草	mehf
坏蛋	hmdr
散在	akgh
高能	xgvk
惟一的	ytu
赢家	pdaq
詹姆	mzxo
取名	bxbo
这头	wrot
就怎么	xkc
马路上	zbi
勾结	svsk
抽样调查	jgug
写实	asao
责怪	mdyx
则由	daey
先知	qaeo
惦记	yrue
将比	qblb
党的十一届三中全会	zuyi
正准备	tew
之星	gzfc
九十年代	kyem
只因为	oze
做爱	ipeg
使命感	ial
工商行政管理	vnde
也发现	une
取证	bxut
花在	high
如何是好	xifx
大大小小	ddvv
达成协议	dlyu
气派	aqvz
刻画	satn
惋惜	yaya
区划	jxla
第二位	nwi
松散	gmak
研究机构	tagg
那么简单	lcnk
它又	alxy
转弯	ywrc
月间	kynf
来时	qkfj
满头	vhot
承德	dzdy
消肿	veko
迷惘	kryn
明朝	fkyy
深山	vaws
火速	whgo
技术员	jgo
交易所	pfz
排便	jbix
冲刷	eorb
脉络	kusw
平壤	hkhp
帮手	kpjs
心脑	cxkw
中国社会科学	ozdz
补上	piit
回房	zoqt
监事	anjo
经济发达	svnd
握紧	jrax
一跃	tybc
淮海	vyve
中亚	ovoy
作响	ikou
严惩	ocdt
鲜红	rmsv
叹气	oxaq
矫情	ecyl
事前	joqx
干劲	hgbv
拚命	jvao
国家领导人	zaii
很小的	dvu
经不起	smr
出道	vcqc
叹了一口气	odta
之交	gzpr
难吃	xyoe
当头	ebot
越野	rlhs
置信	cyiu
大家庭	dar
柳州	gpsz
皆是	luft
宣讲	atuu
一栋	tygy
营业厅	xoz
三只	csom
抗争	jpmb
不差	mbmv
邮局	epre
静电	lmfi
预处理	swe
您在	imgh
女星	xnfc
放眼	twmk
国家利益	zamq
讨论会	uui
防盗	ptef
客家	awaq
几十万	nyt
认识上	uui
事态	jodu
北京奥运	kxua
纯化	slil
大理石	det
发芽率	nhp
可变	jkrx
边远	srjr
信箱	iung
动不动	ama
哪一种	otm
当兵	ebdm
嗓门	oxnm
捐资	joef
沉闷	vanc
网卡	nxio
好强	xico
就有可能	xgjv
有经验	gsz
该去	ushv
再如	enxo
炒饭	wmmz
一卷	tyne
匕首	lbqc
藏着	hlmm
磨难	ryxy
它要	aldx
痛得	fsdf
看不出来	jmvq
厉声	ztrs
杜甫	ghjf
分会	mfia
唐僧	rbik
剪头	qxot
任选	isqa
青岛市	lep
移动通信	masi
蓦地	izhu
红衣	svpy
雅虎	txqn
店员	riod
两党	zlza
路易斯	bfm
不是一种	mftm
平常心	hzc
借助于	igh
样样	gmgm
第一件事	ntij
他爸	iurv
纵使	siix
登时	btfj
无怨	hibe
自然辩证法	cbwv
张床	cyrg
请了	uldj
补救	pizu
抄袭	jmgp
狭小	qyvx
热水器	pzo
风化	nfil
想从	gmii
食品安全	foys
不朽	mbgv
下头	oxot
依稀	ipmx
山大	wsdd
不孕	mbli
伟大旗帜	idtb
坚持下去	ajoh
副总经理	pkse
帮帮忙	kky
为谁	esuy
惊异	yxeh
遥感	eqlt
独生子女	qcix
以南	byxq
亦即	rykp
体液	igvp
脱节	kkhp
双胞	xxks
岂能	wevk
行吗	dloz
水中捞月	zojk
跳楼	begk
烈火	bawh
招人	jmir
各路	wgbw
说出口	uvo
每分	eomf
好话	xiua
享受到	xet
抽空	jeav
大巴	ddvb
二十一世纪	wyts
发展势头	nrpo
信服	iukp
男童	nswh
新闻出版	nnvt
是时候	ffi
房中	qtov
聚在	bxgh
不凡	mbnu
新诗	nduh
自由度	cer
没有钱	vgl
下马	oxzm
至高	tvxg
卫生局	pcr
惊吓	yxoo
再者	enez
和约	moss
突出重点	avai
内功	knvs
分红	mfsv
看多	jmbb
没准	voey
脚踏实地	kbah
第三方	nct
哆啦	oboj
思想认识	nguu
穆斯林	mmy
地名	hubo
求实	zuao
之差	gzmv
任教	isei
那部	lpwo
回信	zoiu
显性	foyc
突破性	aty
诚挚	ulpj
加工业	wvo
找上	jlit
年关	evkd
篇章	nqoz
斯坦	mdhf
月起	kyre
租房	mgqt
天理	tdeh
满分	vhmf
管理费	nec
偷懒	iayg
阵营	pyxo
总收入	kyc
造假	krir
装在	qhgh
目的就是	muxf
雕像	nhie
多给	bbsa
困死	zgbl
重要问题	adnf
杯酒	gmvd
省略	mmnw
民主监督	epai
工作时间	vifn
办成	smle
荣耀	xgea
密密	acac
回忆起	zyr
实拍	aoju
你爹	imrb
乙酰	gydq
法郎	vhuk
白银	ublk
倾城	ilhl
限额	pkaw
书桌	dpif
庸俗	rbiw
公德	mvdy
部下	woox
一动不动	tama
交朋友	pkg
怎麽	kcry
审计局	aur
可溶	jkva
捷径	jtdb
老王	elew
设计方案	uuty
器具	oogm
劳动人民	xaie
红糖	svkr
乡土	scht
对正	xjtr
耕作	quik
退伍	kric
沉迷	vakr
冲刺	eogn
剧组	rpsg
大刀	ddmd
有一套	gtd
只鸡	omxe
关掉	kdji
国际惯例	zpyi
惊愕	yxyo
凝重	esah
面颊	tcyk
比较容易	lyaf
觉察	zuab
武将	tlqb
经理人	sei
驱使	zjix
什麽	iyry
景物	fxqs
副秘书长	pmdy
已经知道	eseq
手贱	jsdt
愧疚	yufm
已婚	eyxp
影响我	foj
重要方面	adtt
小刀	vxmd
更远	xfjr
骨盆	ygmi
桂花	gbhi
合资企业	aeio
威尼斯	lrm
战绩	ilsm
铭记	lbue
好怕	xiyu
城中	hlov
接通	jwsj
涌上	vsit
讲台	uuvo
总督	koix
购进	dsur
会所	iazr
沈阳市	vpp
大伙儿	dia
硅胶	tbkp
利比亚	mlo
甜言蜜语	auau
有可能是	gjvf
韩庚	yyrb
才到	jcth
性子	yciz
最关键	fkl
交流会	pvi
求人	zuir
南都	xqep
恶毒	ocmo
下定决心	oaec
心惊	cxyx
妖怪	xcyx
墙角	hymj
四射	zapj
卫士	pths
圈圈	znzn
爹爹	rbrb
响声	ours
多头	bbot
开挖	thja
印发	ppnf
痛经	fssb
流过	vpjr
月出	kyvc
搜狐	juqr
对头	xjot
请注意	uvw
咪咪	okok
下学	oxzi
斗篷	kdnw
百事	tfjo
抢占	jjiz
再无	enhi
理论体系	euic
帮扶	kpjy
造船	krbn
超多	rmbb
打上	jxit
名副其实	bpma
林彪	ylqn
感染者	lve
侄女	itxn
每条	eowg
上来说	iqu
入市	cupb
斯文	mdww
维系	sycs
心扉	cxqb
阴天	pktd
哭过	oojr
矿物质	tqz
沦为	vies
近些年	dre
依存	ipgi
官司	auet
无意识	hwu
引诱	cvum
中空	ovav
手背	jskl
底蕴	rphs
二奶	wexl
无极	higl
从无	iihi
下颌	oxao
这件事情	wijy
食道	fsqc
木耳	gmbe
原装	zuqh
世界上的	uniu
时隔	fjpt
狗腿	qskk
地下室	hoa
报答	jpna
张望	cypk
记性	ueyc
韩愈	yyax
变老	rxel
尘土	vhht
现代主义	empu
进场	urhl
先发	qanf
心智	cxeo
落成	pwle
积聚	mobx
喜好	kqxi
科研机构	mtgg
反差	zxmv
背离	klwz
年收入	eyc
雨后	zyko
村镇	gjly
那是什么	lfic
古希腊	pxk
心如	cxxo
索赔	yadw
喜怒哀乐	kxpp
议程	uumo
重用	ahjy
难做	xyip
便携	ixjy
充满信心	pvic
节操	hpjo
介于	iahy
又都	xyep
弄虚作假	eqii
行进	dlur
隆起	pwre
一箭	tynq
追加	urwj
通知书	sed
同日	ntfr
失利	esma
军团	ayzj
科尔	mkmv
眼看着	mjm
牙刷	txrb
尊贵	qjcg
复议	efuu
富翁	apmv
玲珑	eieg
夜景	pifx
双胞胎	xkk
惩处	dtwi
很有可能	dgjv
义气	uxaq
国民生产总值	zeci
安康	yarb
维也纳	sus
滋补	vqpi
面无	tchi
扶正	jytr
成就感	lxl
内河	knvj
年长	evyc
压岁	zhwb
养老金	mes
一晃	tyfe
扇门	qbnm
哭声	oors
专为	wves
伸直	ifyg
一见钟情	tuly
总编	kosq
京都	xvep
很长的	dyu
警报	hwjp
摩托罗拉	rjcj
出神	vcdf
喝过	ofjr
苦瓜	hprg
自给	cmsa
收纳	ywsk
念书	iddp
贺电	wdfi
我国政府	jztr
苛刻	hjsa
全国范围内	szpk
时限	fjpk
几项	njvt
我晕	jlfa
黑头	dhot
田地	nthu
瞳孔	mwii
不假	mbir
步履	rmrd
可人	jkir
更不是	xmf
炸药	wkhs
日本国	fgz
老一辈	etb
著称	hemm
丢弃	atph
格调	gwun
共同富裕	anap
癌变	forx
紫薇	rlhf
请进	ulur
海马	vezm
念念不忘	iimp
未及	qwlj
北平	klhk
补给	pisa
批发市场	jnph
哽咽	oxoz
棘手	gnjs
民办学校	eszg
摸着	jimm
叛逆	czkn
需要的是	zduf
又像	xyie
俏皮	iegp
款项	hnvt
满心	vhcx
朝天	yytd
撑着	jzmm
新一届	ntr
极为重要	gead
国务卿	zwp
取悦	bxyk
救出	zuvc
中叶	ovoy
大棚	ddgk
公分	mvmf
宫殿	aora
说不出话来	umvq
苏打	hsjx
获得者	hde
牧场	qwhl
方舟子	tbi
他不知道	imeq
七分	lqmf
发过	nfjr
变压器	rzo
长风	ycnf
小提琴	vje
融为一体	teti
文物保护	wqij
长假	ycir
设计者	uue
也这样	uwg
胡同	pknt
想逃	gmee
重构	ahgs
七百	lqtf
本区	gtjx
积淀	mova
英美	htmd
云集	ayyg
表象	mqex
脚上	khit
数次	kxef
这是由于	wfeh
补课	piuf
运费	arca
之乡	gzsc
试制	ulqn
南风	xqnf
同种	ntmo
弄清楚	evy
洞察	vnab
这起	wrre
相称	gmmm
修好	iwxi
供不应求	imrz
快报	ytjp
弯腰	rckd
一个又一个	tixi
这么的	wcu
扔了	jldj
频谱	rmuq
土层	htra
文坛	wwha
草木	hfgm
人类文明	ikwf
进货	uril
龙马精神	gzkd
不鸟	mben
长白	ycub
傻笑	iunc
苦了	hpdj
紧迫感	aul
脑膜	kwki
独立自主	qwcp
国家统计局	zasr
好样的	xgu
麻雀	ryvy
自救	cmzu
求证	zuut
年产量	ewf
拍着	jumm
沧海	vjve
减产	elwc
众议	iiuu
夜班	piey
全自动	sca
仓储	jciu
是那么的	flcu
听觉	odzu
卧床	jvrg
四个方面	zitt
拼了	jqdj
较深	ypva
传热	iwpt
管子	naiz
核电	gsfi
细雨	snzy
匮乏	jccg
到那里	tlh
火力	whsl
雄心	gvcx
新气象	nae
区位	jxiw
必然是	cbf
招手	jmjs
农林	bqyl
无私奉献	hmux
骂道	ooqc
老友	elgx
草场	hfhl
问答	nona
我知道了	jeqd
保护环境	ijeh
有之	gkgz
肾炎	axww
出力	vcsl
学士	zihs
小龙	vxgl
印证	pput
总人口	kio
南联盟	xbf
偏重	iqah
国际奥委会	zpui
羊毛衫	mqp
递交	kcpr
路途	bwvr
之长	gzyc
一袋	tymp
公事	mvjo
署名	cebo
妞妞	xoxo
冲过	eojr
贵重	cgah
杂乱	kgai
爬山	rvws
打进	jxur
裁定	ylat
映射	ftpj
这段话	wdu
上相	itgm
荒凉	hpex
脂肪酸	kkd
一死	tybl
职业技术	bojg
歌颂	jjmv
公诉	mvud
就医	xvje
一直有	tyg
外甥	bicm
找找	jljl
海南省	vxm
伴着	icmm
地里	huhl
非人	bfir
营业员	xoo
柔弱	sxce
青龙	lqgl
接线	jwst
羟基	mbmh
取其	bxmq
鼓浪屿	kvw
不屈	mbrv
结识	skuo
朵花	nghi
国语	zeuc
茶几	hinj
吃屎	oerk
幼苗	sshn
奥秘	ukmc
环境条件	ehwi
恍然大悟	ybdy
不露	mbzb
退役	krdo
背负	klif
迟缓	arse
诗句	uhso
石子	tsiz
回眸	zomv
地支	huyx
论语	uiuc
不同的人	mnui
不知怎么	mekc
暨南大学	kxdz
爪子	rziz
鸟类	enkd
攀升	ggch
表率	mqps
还是可以	mfjb
算了吧	ndo
提要	jfdx
写好	asxi
考了	evdj
不正确	mtt
雪糕	zbkm
因为如此	zexr
陪在	pwgh
打针	jxly
则可以	djb
上手	itjs
跨越式	brl
油炸	vewk
课题组	ufs
接上	jwit
送货	kdil
趁机	rign
许多地方	ubht
分支机构	mygg
袭来	gpqk
含泪	idvm
纸张	spcy
中段	ovdo
凳子	btiz
威严	ltoc
西门子	dni
选中	qaov
母校	omgp
配角	demj
跑道	bsqc
偏执	iqpz
受苦	exhp
栖息	gdcm
中长期	oym
不尽相同	magn
和田	mont
官僚主义	aipu
数十年	kye
根本无法	gghv
层面上	rti
全靠	sqkb
四下	zaox
说出来	uvq
往里	dphl
份上	imit
立志	wlhc
慢了	yfdj
宝山	aews
浮夸	vedw
光源	etvz
行为规范	deyp
养育	mupk
油管	vena
删掉	saji
货源	ilvz
军营	ayxo
等价	nhii
个原因	izz
共存	amgi
相守	gmaj
从小到大	ivtd
调料	unkk
下回	oxzo
外滩	bivx
国际合作	zpai
露面	zbtc
本草	gthf
掩护	jdjq
食盐	fshi
某种程度上	hmmi
内幕	knib
赶出	rhvc
日美	frmd
狗血	qsci
排尿	jbrz
寄来	adqk
联播	bkjc
听我说	oju
学姐	zixg
厌烦	zdwt
上瘾	itfp
大汗	ddvh
航海	bpve
插在	jagh
碰见	tquj
重大意义	adwu
生来	cmqk
瓷器	efoo
承接	dzjw
腰围	kdzw
磁带	tqma
当众	ebii
惨叫	yvoy
住手	ipjs
深入学习	vcze
回乡	zosc
婚事	xpjo
战斗机	ikg
乡亲们	sni
秋风	mwnf
那把	lpjv
直言	yguy
打车	jxyc
图上	zwit
徐徐	dvdv
摊位	jxiw
血脉	ciku
理直气壮	eyaq
冬眠	weme
毛钱	qmlt
印制	ppqn
状元	qdjy
追溯	urvk
睿智	iaeo
标示	gnns
讲学	uuzi
后边	kosr
城门	hlnm
再走	enrz
足坛	bzha
街拍	dbju
张爱玲	cee
碎石	tpts
保险业	ipo
稽查	mugf
国税	zemk
共用	amjy
好手	xijs
此书	rldp
吃完了	oad
仍需	ilzt
凝望	espk
核对	gsxj
瞌睡	mhma
不远处	mjw
欢庆	xfrd
有帮助	gkg
海宁	vean
为那	eslp
又是什么	xfic
折断	jdki
早些	fyrl
什么呀	ico
独处	qcwi
我想知道	jgeq
昏暗	plfw
这就是说	wxfu
热火	ptwh
揭秘	jfmc
诊所	uizr
放任	twis
守法	ajvh
流了	vpdj
查到	gfth
狗屁	qsrl
液态	vpdu
难关	xykd
妥当	exeb
大戏	ddxl
威风	ltnf
埋葬	hhhb
运动服	aak
为嘛	esor
混搭	vfjh
醒过来	djq
哪家	olaq
免不了	mmd
记着	uemm
没怎么	vkc
创出	javc
血缘	ciso
肝病	khft
呼喊	ocol
才可能	jjv
沉稳	vamm
东欧	yvjx
广为	rges
算不算	nmn
牛人	qnir
长着	ycmm
守门	ajnm
把握好	jjx
一个一个	titi
定义为	aue
黄花	aehi
相联系	gbc
自欺	cmmf
栗子	dgiz
充填	pahy
新专辑	nwy
中超	ovrm
收缴	ywsu
串行	oodl
场馆	hlma
友善	gxmq
方正	tftr
屠杀	rexg
换届	jmre
呼应	ocrz
金光	sjet
资本家	ega
等车	nhyc
国际性	zpy
没机会	vgi
学识	ziuo
站到	with
浦东新区	vynj
停了下来	idoq
拉下	jwox
主题曲	pff
灵通	bwsj
见义勇为	uuse
胡适	pkar
也即	uykp
铸型	lkta
乾坤	yyhf
第一版	ntt
刚过	nxjr
小道	vxqc
均应	hsrz
气象台	aev
车牌	yctu
种种原因	mmzz
许多的	ubu
有份	gkim
寺庙	hjre
老去	elhv
正大	trdd
普陀	qopa
腐烂	riwq
辩解	wumj
单打	kfjx
勿扰	sdji
形而上	tti
出示	vcns
存有	gigk
生性	cmyc
不灵	mbbw
校友	gpgx
支票	yxdn
视听	duod
捆绑	jzsk
大增	ddhk
多党	bbza
眼霜	mkzg
位高	iwxg
靓仔	luii
很长时间	dyfn
迎着	ppmm
中小学校	ovzg
手帕	jsbu
乡里	schl
人脑	irkw
三口	csok
车速	ycgo
平底	hkrp
反常	zxzb
远远超过	jjrj
捐献	joxd
恳求	kczu
放牧	twqw
这个时间	wifn
低收入	iyc
国有股	zgk
基本情况	mgye
指导意义	jewu
杀虫	xgcc
恐怖分子	vymi
半生	cbcm
房内	qtkn
心口	cxok
弗兰	caqw
回扣	zojo
任何一种	iitm
对于我们	xhji
开罗	thcb
连续剧	ysr
城市居民	hpre
并同	qhnt
后无	kohi
随心所欲	pczw
西部开发	dwtn
走狗	rzqs
富余	apvy
运力	arsl
不认为	mue
活儿	vaae
想家	gmaq
走远	rzjr
薄薄	pjpj
阴霾	pkzq
长者	ycez
只吃	omoe
分批	mfjl
不归	mbab
你们好	iix
水玻璃	zee
调查组	ugs
理论依据	euij
先进生产力	qucs
学过	zijr
暴躁	fabo
换句话说	jsuu
依附	ippi
必然要求	cbdz
勤政	hmtr
小巷	vxam
中世纪	ous
电荷	fihi
汇编	vjsq
王力宏	esa
沿用	vnjy
摆着	jcmm
挫伤	jiie
郑州市	ksp
千余	aqvy
涂上	vvit
留存	pmgi
错位	laiw
花香	himf
中宣部	oaw
求救	zuzu
没有别的	vgku
饰演	meva
喝彩	ofeg
结合在一起	sagr
金发	sjnf
披肩	jgqk
供热	iapt
水田	zsnt
天台	tdvo
翻箱倒柜	cnig
带入	macu
冰块	ezht
今朝	idyy
主导作用	peij
释怀	ckym
大打	ddjx
本位	gtiw
瞅着	mmmm
翻唱	cnof
居于	rphy
仙子	iwiz
轻型	ybta
废气	rnaq
责任编辑	misy
护卫	jqpt
黄菊	aehs
那么一点	lcti
盘中	biov
皮包	gpsb
国际组织	zpss
并不一定	qmta
静安	lmya
也称	uymm
好戏	xixl
毕生	lycm
教育部门	epwn
心理咨询	ceeu
充盈	palx
工作能力	vivs
接送	jwkd
关系密切	kcal
没来得及	vqdl
没什么好	vicx
抹去	jqhv
两者之间	zegn
将可	qbjk
恒定	ytat
热恋	ptrc
不因	mbzd
持之以恒	jgby
将把	qbjv
养活	muva
是不够的	fmsu
劳动合同	xaan
首映	qcft
对视	xjdu
共振	amjz
受制	exqn
先要	qadx
牙龈	txrz
富民	apel
宽恕	ahxo
佳节	ibhp
校外	gpbi
母爱	omeg
出线	vcst
汤加	vlwj
晚辈	fmby
白纸	ubsp
这一类	wtk
中国画	ozt
情深	ylva
德行	dydl
绿洲	sbvs
引向	cvuo
淡泊	vwvu
流着	vpmm
讲故事	upj
蜗牛	coqn
学堂	zizh
吼道	oiqc
家国	aqze
政治体制	tviq
权势	gxps
日新月异	fnke
农村人	bgi
官吏	auxo
脊椎	kagy
感受到了	letd
村落	gjpw
肚皮	khgp
日久	frmu
大跃进	dbu
硬道理	tqe
水泵	zstz
保证金	ius
淮河	vyvj
奥巴马	uvz
生理学	cez
工作环境	vieh
名师	boat
不怪	mbyx
刺激性	gvy
绝对不是	sxmf
赖床	gorg
匈奴	sxxx
全球性	sey
大拇指	djj
滤波器	vvo
百分之百	tmgt
班组	eysg
教养	eimu
喝得	ofdf
迁就	arxv
麻疹	ryfi
纯正	sltr
国门	zenm
买车	doyc
集中于	yoh
惊动	yxas
研究领域	taih
名胜	bokc
得早	dffy
老伯	eliu
演说	vauk
乙酸	gydv
单核	kfgs
上辈	itby
出众	vcii
爆破	wftg
不嫌	mbxq
药业	hsoy
意念	wfid
转角	ywmj
通告	sjkg
无畏	hinq
可怕的是	jyuf
该不会	umi
小看	vxjm
秀发	mlnf
发展模式	nrgl
盈盈	lxlx
核苷	gshh
了然	djbu
个体户	iiq
这已经	wes
干掉	hgji
眼影	mkfv
阴雨	pkzy
这辆	wryz
犯规	qeyu
开庭	thrs
交易会	pfi
重工	ahvg
一定程度的	tamu
那群	lpbc
条规	wgyu
辨识	wyuo
表征	mqdt
压岁钱	zwl
光头	etot
害得	akdf
机身	gnps
吹风	ofnf
睡过头	mjo
停火	ixwh
先有	qagk
周公	nhmv
不睡觉	mmz
势在必行	pgcd
泉水	uzzs
想尽	gmae
研磨	ttry
小李	vxgi
打个电话	jifu
断层	kira
雇佣	qyij
吝啬	woyq
口干	okhg
便当	ixeb
一般性	tby
令人满意	iivw
塌陷	hfpm
天道	tdqc
一生一世	tctu
时至	fjtv
殿堂	razh
书刊	dpha
太祖	dudg
总长	koyc
别处	kawi
移动电话	mafu
负责任的	imiu
华西	ildx
用之	jygz
过半	jrcb
外向型	but
一天到晚	tttf
个人利益	iimq
层出不穷	rvma
之列	gzba
能忍	vkmu
特务	qhws
难找	xyjl
分发	mfnf
