的	kre
一	jjy
了	vkl
是	gjx
不	sjb
我	ktw
这	znz
在	chz
人	wmr
有	huy
他	dkt
来	xcl
个	wfg
道	cun
你	dnj
大	mjd
到	fvd
着	pqz
就	zje
上	njs
们	dym
那	hdn
也	kvy
说	ecr
么	mqm
下	cjx
出	fic
然	ner
地	hkd
中	yfz
看	kqk
时	gos
要	qxy
没	jrm
天	jmt
过	ong
可	gjk
自	umz
子	bvz
能	qul
还	snh
之	oez
以	jvy
去	hqq
好	xbh
后	xoh
为	ccw
都	ydd
会	wih
里	afl
心	vex
得	hgo
对	iod
身	ems
手	kms
起	xdq
小	jfx
想	rvx
只	osz
而	bae
和	voh
头	let
她	xkt
无	hlw
力	cvl
面	bqi
己	dvj
如	xor
现	ulx
什	das
样	wpy
多	nnd
已	dvy
知	aoz
些	xli
经	ahy
声	hss
前	cuq
神	tgf
笑	fmm
事	foz
开	pjk
点	nrd
方	uef
眼	qoy
发	xvf
所	vse
但	dgj
气	tmq
法	jhq
意	ivy
情	npu
两	ejl
生	mps
家	llj
间	ygj
将	cno
很	hoh
真	aus
话	efh
成	toc
让	enj
被	tob
老	yll
动	icd
当	bzd
用	bmy
于	hjy
见	lfj
回	soh
又	ivy
军	lgj
把	kgb
此	xlc
才	ljc
几	pmj
战	ntz
正	jxz
龙	ojl
明	gum
从	tmc
却	hqd
长	xmc
十	ajs
三	bjs
女	xvn
光	bjr
再	upz
向	cox
实	lls
最	gyi
行	hex
高	zog
本	wjb
打	kdd
定	ljx
进	rnj
魔	mwr
风	pmf
给	awo
问	yow
国	sue
色	ngs
同	pjo
种	vyz
走	xjz
其	qjq
年	aln
口	ofk
王	ujw
怎	hvz
边	cnb
次	cyc
全	wuq
白	kmb
吧	ogb
儿	rme
感	tjv
果	gwg
听	oet
啊	odg
体	dwj
外	nnw
死	nls
飞	ocf
分	skf
主	tez
觉	blj
住	dtz
少	jfs
比	ljb
空	lyk
因	smy
门	yem
等	fho
轻	ghy
直	auz
第	fxm
候	dsa
脸	uwb
相	rjx
强	xov
何	dgh
张	xxz
快	ndk
做	duk
重	faz
与	sjy
太	met
应	mby
刚	piv
接	kfx
位	dfw
便	dji
量	gja
更	jgi
难	iun
名	nom
二	ije
内	ifn
连	gnl
水	pfs
西	qjx
黑	cfh
马	ivm
部	fod
入	mer
作	dhz
吗	oim
兵	esb
师	vjz
虽	ovs
别	yvb
击	hfj
放	ukf
完	lvw
四	srs
灵	zsl
公	sqg
并	cpb
先	zrx
处	knc
士	hjs
剑	wbv
算	fqr
东	tjd
机	wpj
微	fpw
城	hto
火	seh
变	zib
叫	onj
清	jpu
带	clz
杀	iws
斯	qes
李	wbl
队	dwd
云	ijy
者	yjz
望	tuu
原	vkj
竟	irj
像	dxx
惊	nzj
呢	osl
安	lxa
山	ifs
星	gmp
族	uaz
海	jap
月	umy
加	hvj
金	cmj
目	qfm
特	zho
跟	yog
场	hhp
林	wjl
由	sfy
万	bow
美	pmm
任	dcr
使	dio
日	gfr
立	fel
命	wod
思	svs
关	cmg
百	bgb
转	giq
理	ual
常	boz
血	max
乎	mcf
受	bis
离	zfp
该	eyg
界	swv
远	vny
平	hcp
阵	dgz
物	zrp
冷	cie
数	gxk
信	dex
刻	yvk
至	fjz
突	lme
失	ams
怪	nih
随	dhn
五	vjw
反	vif
找	ktz
似	djs
许	ezx
般	prb
武	jtx
雷	esl
非	yff
奇	mgq
通	qbn
解	nbz
绝	ang
怕	nkp
精	gpu
修	dkf
暗	gia
满	jre
双	iis
度	mri
且	ufq
红	ayh
半	yeb
世	fjs
始	xqo
倒	dfv
拉	kfl
今	imj
它	llt
落	gkl
攻	ykg
学	bbx
尔	nje
传	diq
音	iey
指	klg
路	ykl
越	xtl
表	peb
石	bjs
容	lbr
紧	vij
哥	ggg
合	woh
罗	qnl
利	vvl
冲	cyc
步	xjb
够	ron
影	gjf
姐	xuj
伤	dac
若	rho
亲	fwq
功	ycg
整	wkx
弟	cxm
丝	aaj
息	uvx
吃	oao
众	wtz
花	rdl
势	pcs
早	gaz
哈	owo
帝	fzd
流	jti
团	slt
青	puq
根	wog
极	whj
静	puk
形	pfx
即	odj
深	jlw
周	pho
近	enj
千	fmq
消	jbu
结	afj
制	zpv
干	hjg
帮	ydz
速	won
楚	wvx
性	nmp
备	ksb
系	maj
言	eey
提	kgx
教	ybk
皇	kuh
令	iel
文	zew
雪	ezx
谁	eus
终	akc
必	vmb
站	fnz
化	dlh
哪	ohd
破	bop
认	ewr
忙	ntm
往	htw
玉	uey
级	ahj
车	gjc
底	mar
总	cov
坐	thz
巨	psj
男	scn
显	gkx
克	urk
各	kmg
新	fwe
斗	led
仙	dix
急	nzv
切	rkq
阳	dgy
叶	oay
领	ieb
收	nks
衣	tey
敢	vyk
异	dry
围	sid
达	mnd
象	xmx
件	dzj
错	cng
服	udi
慢	ngi
保	dow
办	csb
活	jfh
喜	fco
片	imp
杨	whp
兴	bsx
刀	kvd
摇	kbz
准	cuz
夜	tdk
拿	wok
电	gld
交	tlj
条	kwt
朝	aau
华	dla
管	flr
断	gle
兽	cso
决	cdj
尽	mcj
苦	ruk
依	dte
易	grp
八	smb
则	qvz
露	eyk
语	evo
兰	cil
闪	yws
冰	cpb
足	yfz
记	edj
德	hav
响	oco
害	lyo
及	hmj
球	upe
阿	dga
计	eaj
顿	rfb
爱	bhi
告	zog
夫	bjf
七	rjq
嘴	olb
器	zmz
圣	ihs
南	zca
留	aks
元	vjy
敌	fkd
沉	jlp
请	epu
官	lrg
威	tjx
每	apm
况	cor
确	bnb
答	fwo
乱	fll
陈	dtj
宝	lue
视	tls
护	kfh
格	wkg
脑	uzf
兄	orx
狂	luk
淡	jss
识	eos
题	gxb
停	dzd
司	ojo
低	dar
雨	ejy
呼	omf
久	nej
未	xjw
孩	byh
卫	djw
脚	uhd
除	dww
古	ujg
亚	kjy
字	lbz
骑	img
房	fuf
代	smd
伙	dsh
鬼	krq
员	oqy
缓	abi
复	agk
六	tsl
黄	nss
装	che
居	suj
凌	chk
呵	ogh
米	gem
恐	ypv
单	cga
旁	fup
钱	cjt
跑	yrd
布	hzb
或	toj
爷	ldy
玩	uvw
报	kdi
疑	lax
术	wes
睛	qpu
隐	dnv
欢	iyh
续	aal
章	iaz
差	pyc
挥	klg
父	lmf
句	roj
待	hho
九	qmj
派	jve
持	kho
类	gml
宇	lhy
丽	jpp
蓝	rva
佛	dxv
刘	zvl
忽	rpv
怀	nsh
您	dnv
怒	xiv
掉	kna
招	kko
希	ihz
送	cmn
背	clu
工	yjg
甚	qls
烈	nvr
卡	nck
细	asx
掌	bok
论	ewl
密	lvi
运	iny
退	ont
酒	jqj
求	peq
猛	lba
另	yfl
射	eos
集	uwj
首	cus
北	clb
照	gkr
晚	gnr
赶	xhg
守	los
木	wjm
散	nuk
穿	ljd
联	ycm
铁	cat
段	yrd
练	atj
喝	ogr
需	eba
支	aiz
巴	gvb
左	hyz
陆	dhf
角	nbj
书	vde
防	duf
忍	kev
莫	ejm
群	zmp
民	drm
客	lkk
线	ajt
毫	zfh
肯	xuk
展	sne
谢	eeo
亮	zpl
痛	mqb
股	urg
造	zon
妖	xmm
虎	fph
秦	pvq
紫	xlj
宫	loo
激	jkk
赵	xiz
渐	jge
震	eve
注	jtz
禁	wij
吸	ohx
取	yiq
梦	wnm
枪	wwd
程	vou
叹	oit
江	jyj
简	fyg
羽	zvy
友	hiy
继	agl
念	ivn
右	hoy
萧	rzj
热	prr
份	dsk
乐	ajl
压	vhe
既	oej
靠	zoy
香	vgx
恶	kve
引	xfy
止	xfz
包	rdb
追	rnz
仅	dij
寒	lnc
雅	jdu
争	nzk
愿	vkv
超	xko
狠	loh
厉	vbo
式	tys
波	job
刺	wpv
号	oqh
态	mev
存	cbc
游	jub
台	qot
跳	ycc
狼	leo
属	smp
妹	xxm
炼	stj
灭	jsm
英	rdy
醒	qgp
举	bsh
嘿	och
境	hir
胜	ump
诉	eee
抱	krd
毕	lab
务	kcw
甲	sfj
齐	zvq
拍	kkp
唐	mzo
君	zmo
楼	wgx
险	dwb
院	dlv
建	zhn
观	ilg
柔	qdw
逃	ccn
置	qau
娘	xeo
担	kgj
殿	snr
阴	duy
呆	owd
层	sic
试	ety
约	are
凡	pef
眉	sqm
弹	xca
救	pek
银	coy
统	atr
否	sof
索	alj
抓	ksz
府	mdo
调	eph
曾	cgg
魂	ikr
基	qhj
顶	dbd
峰	iky
苏	rcs
图	skc
松	wsq
议	eei
料	gll
顾	vdb
严	kmy
业	kfy
恩	smv
礼	tll
耳	yje
选	zrn
余	wwy
败	qkb
区	piq
顺	ibs
皮	ovp
沙	jjs
瞬	qbl
树	wio
秘	vvm
商	zbs
组	auz
块	hdk
汉	jih
充	trc
贵	vqg
迷	gnm
混	jgl
纷	ask
示	ijs
伸	dgf
娜	xhd
助	ucz
呀	ojd
封	aof
排	kyp
期	quq
肉	iwr
船	ppo
座	mth
义	eiy
舰	plj
闻	yyw
升	mrs
室	lfs
妈	xim
亡	tew
付	dof
控	kly
警	rke
负	nqf
推	kut
扬	khp
模	wem
芒	rtm
凤	pif
虚	fkx
默	cme
土	hjt
技	kai
费	xvq
温	jga
市	tzs
麻	mwm
初	tkc
考	yqk
拥	kby
究	lqj
握	ksf
资	cyq
普	ckg
翻	msz
察	lei
独	lvd
幸	hca
舞	anl
称	vnj
玄	aex
母	pvm
暴	gnp
按	klx
孙	bjs
睡	qfn
改	dkg
换	knm
素	paj
较	gtl
具	usj
箭	fcu
品	ozp
忘	tvw
状	cme
堂	boh
副	nvf
承	vpb
野	aqd
锋	cky
洞	jpj
遇	spn
查	wgj
洛	jkl
局	soo
赛	lnq
划	tvh
权	wiq
藏	rtb
味	oxw
丹	ptd
故	ukg
钟	cyz
坏	hsh
仍	dhr
宗	liz
弱	xcx
弄	urn
脱	ucr
菲	ryf
胸	uri
哼	ozk
药	rar
历	vcl
徐	hww
拳	pkq
爆	sgp
杰	wrj
谈	ess
须	fbx
坚	vih
奥	cgm
仿	duf
据	ksu
偷	dwu
施	uks
产	fmc
营	rlo
骨	qfg
晶	ggg
透	vhn
尊	coz
短	ajc
抬	kqo
政	jxk
烦	sbf
河	jgh
牙	jdy
维	auw
证	ejx
卷	pdj
幽	iaa
草	rga
森	wws
吴	ojm
摆	kqq
蒙	rll
危	nvd
毒	ppd
投	krt
熟	zqr
飘	qip
导	dod
朋	uup
质	vaq
释	mgh
喊	otj
胡	uuh
参	qmf
休	dwx
劲	hyc
景	gzj
挡	kbz
印	ady
惜	nng
枫	wpf
幻	aoh
欲	sby
摸	kem
烟	ssm
致	fkz
州	iez
冥	lgs
尼	sln
抗	ktp
妙	xjm
翼	zss
秋	vsq
凝	cqx
寻	zox
盘	pap
永	epy
板	wvi
智	aog
哦	okt
责	pqz
尸	svs
傲	dra
柳	wad
御	had
临	vfg
浪	jeo
辈	ygb
娇	xmv
恨	noh
吓	ocx
价	dwv
硬	bji
探	klw
际	dij
横	wns
标	wib
纳	ain
欧	piy
宁	ldn
墙	has
田	sft
习	ovx
肩	fuj
戏	itx
奈	min
设	ers
效	tlk
福	tnf
袋	ste
移	vnn
型	pvh
疯	mpf
毛	fmm
贝	qfb
冒	gqm
叔	nji
碎	bta
轰	gii
扑	knp
奋	msf
饭	nvi
科	vlk
惨	nqf
咱	ouz
治	jqo
湖	juu
环	ush
尘	jhc
略	skl
躲	epw
免	nor
盟	gua
珠	uxz
迎	adn
凭	dcp
规	blg
犹	lee
雄	hqu
距	yps
伯	dkb
借	dng
域	hto
床	mwc
骂	zim
莉	rvv
朱	xmz
史	ois
避	sfn
聚	yip
皱	nzo
秀	vhx
韩	aad
挑	kcc
降	dkl
敬	rok
源	jvj
徒	hxt
束	wos
鲜	xpx
撞	kfa
岁	ins
架	hwj
嘛	omw
哭	zme
袭	ote
惑	tov
罪	qyz
节	rdj
罢	qhq
食	nms
啦	okf
唯	ouw
买	vlm
训	eix
腿	uon
稍	vbu
校	wtl
艾	ria
诺	ero
某	rjw
邪	jdd
鲁	xgl
姑	xug
阻	duz
丁	djd
塔	hro
闭	ylb
迅	oan
逸	xny
臣	pfs
残	njt
裂	nve
托	kmr
良	eol
泪	jql
尖	jmj
晓	gtr
伊	dzm
洋	jpy
屋	sfw
尚	bpo
颗	gwb
鱼	xmy
炸	shz
仇	dqc
讲	erj
焰	snx
配	qdp
旧	fgj
绿	azp
假	dsi
圆	soq
验	iwb
番	mgs
搞	kzo
迹	tzn
荡	ghp
彩	bwf
腾	upi
恢	nhs
腰	uqx
厅	vdt
牛	zmn
吼	obl
占	nfz
颤	tjb
趣	xyi
梅	wap
奔	mar
臂	sfu
愣	nqu
勇	qbc
套	mmt
剩	vcv
志	hvz
舒	wud
端	fia
虑	fvl
医	pay
妮	xsl
炮	srd
蛋	vxv
卖	avl
闹	ytz
颜	fmb
归	vzg
圈	spd
限	dox
浮	jbb
弃	trq
适	fns
软	gyr
抵	kar
厚	vgb
帅	vzs
尤	eey
讶	ejd
广	meg
范	gdf
桌	ngw
欣	eyx
病	mji
共	nsg
职	yos
诸	eyz
镇	cas
专	iqz
值	dau
偏	dfa
杂	qwz
增	hcg
豪	zlh
咬	otl
触	nbv
陷	dnx
雾	ekc
挺	kcn
炎	ssy
稳	vnv
择	kih
巧	yqq
胖	uyp
附	ddo
盯	qdd
碰	bck
纪	adj
阶	dwv
谷	sbg
嗯	osv
岛	tid
夏	bqk
扫	kzs
潜	jbg
毁	xyr
项	ybx
旋	uvx
抢	kwd
抽	ksc
优	dee
迪	snd
涌	jqb
网	pii
祖	tuz
拜	kjy
测	jqv
伟	did
案	lxw
列	nvl
谓	esu
操	kow
春	pgc
店	mnd
瑞	uia
善	pco
逼	nnb
浑	jlg
输	gwu
烧	str
瞪	qec
慕	ejm
懂	nra
富	lnf
汗	jhh
侧	dqv
赤	hzc
率	taa
杯	wsb
京	zjj
吉	fjj
滚	jte
曼	gqi
浩	jzo
获	rlm
轮	gwl
损	koq
抖	kld
累	saj
讨	eot
苍	rwd
悄	nbu
养	pev
塞	lnh
鸣	otm
挂	kag
胆	ugj
孤	bsg
傻	dck
陪	dfo
镜	cir
凶	ifx
吐	oht
杜	whd
猜	lpu
庞	mop
幕	ezm
琳	uwl
蛇	vll
拼	kcp
孔	blk
盖	pag
材	wlc
扎	klz
爸	lgb
预	qdb
晃	gbr
闷	yvm
姓	xmp
莱	rxc
仔	dbz
吟	oiy
遍	fan
彻	hrk
纯	arf
伦	dwl
盗	cya
愤	naq
困	swk
缘	apl
纵	atz
啸	ozj
夺	mod
壁	sfh
宋	lws
估	dug
介	wvj
画	jsf
庄	mhz
狗	lro
沈	jzl
贼	qth
补	tnb
摩	mwk
脉	uep
泰	ppt
痕	moh
燕	ror
折	kez
劫	hqc
演	jlj
灰	hsh
伏	dme
悠	dkv
婆	jox
创	wdv
研	bpy
含	ioh
写	lsx
凯	idp
岳	eiy
午	zmw
池	jkc
睁	qnk
萨	rdm
暂	geg
闲	ywx
概	woe
逐	lnz
旦	gjd
登	ejc
误	eom
戒	trj
村	woc
街	hae
跃	ymm
牌	ixp
廷	cnt
罩	qna
斩	gez
班	uvu
爵	boo
陛	dlh
膀	ufu
迟	mnc
踪	yli
替	bbg
谋	erw
伴	dyb
霸	ezu
傅	dio
怜	nie
乌	tmw
曲	gvq
瞧	qur
惧	nus
俊	dqk
歌	ggy
咒	zpz
漂	jqi
嘻	ofo
倍	dfo
采	bwc
昨	ghz
互	jph
鹰	mdt
蒂	rfz
舍	wus
慌	nri
糊	guu
犯	ldf
扭	kpn
判	yvp
丢	fjq
羞	ppx
昏	arg
竹	fmz
唤	onm
忧	nee
锐	ccr
琴	uuv
宽	lrl
莲	rgn
躯	epi
郎	eod
疼	mkc
席	mrz
伍	dvw
剧	suv
碧	ukb
征	hjx
鸟	tmn
赞	zzq
丈	ijz
侍	dho
悉	mgv
漫	jgi
缩	alg
帐	zxz
遭	ngn
坦	hgj
喃	ozc
悟	nvo
壮	chz
辰	vec
貌	lkr
鼻	usr
聊	yad
怨	ndv
弓	xvg
绕	atr
私	vqs
耀	bru
财	qlc
掩	kml
吞	jmo
织	aos
监	vfa
洗	jzr
佩	dpj
融	jpv
插	kfx
梁	jkw
忠	yvz
悲	yvb
笔	ffb
迫	knp
凉	czj
丫	cfy
鼓	fci
豫	qdx
亦	tzy
敏	apk
狱	lme
召	koz
佣	dby
忆	noy
朵	pwd
博	aio
狐	lsh
吹	oyc
拔	kxb
荣	rlw
劳	rlc
茶	rww
缠	ama
盛	toa
磨	mwb
浓	jze
净	cnk
仰	dad
遥	bzn
废	mxf
恭	nsj
菜	rbw
阁	ykg
缺	zdq
粗	guc
躺	ebp
宣	ljj
桑	iiw
绍	ako
惯	npq
遗	vqn
晕	glg
执	pjz
喷	oaq
刹	iwv
努	xic
脆	und
轩	ghx
佳	daj
耗	xfh
窗	lck
积	vos
策	fwp
辉	brg
灯	sdd
辛	fex
援	kbi
堆	hud
扶	kbf
踏	ypg
库	mgk
屁	slp
唇	veo
奴	xin
翔	pzx
熊	qlr
粉	gsk
勒	zcl
尾	sfw
批	klp
乖	fcl
艳	yng
趁	xwf
慧	yyv
姬	xpf
爬	sgp
隆	dkp
怖	nhz
赏	boq
晨	gve
刃	ker
媚	xsq
耐	bao
拖	kak
丰	yjf
码	bim
诚	eto
律	hzh
乃	hvn
赫	hzz
曹	ngc
岂	idq
固	sug
洁	jfj
盾	vaq
社	ths
郭	zbd
骗	ifa
滑	jqh
霄	ebu
隔	djp
纸	aar
戴	ats
额	lkb
惹	rhv
撤	ktk
荒	rti
季	vbj
延	mxn
痴	mao
锁	cbq
旗	uqq
撒	knk
郁	hud
典	pns
颇	obp
侯	dsa
园	svy
振	kve
仪	dei
省	jqs
猎	lng
殊	nxs
绪	ayx
跪	ynd
玛	uim
抚	khl
油	jsy
委	vxw
纹	azw
泉	kpq
滴	jzu
洪	jns
启	foq
供	dns
忌	dvj
拦	kci
祭	eij
妻	azx
贴	qnt
妇	xzf
庆	mmq
擦	kli
币	mzb
婚	xag
牢	lzl
仁	dir
甘	rjg
奶	xhn
径	hhy
倾	dlb
符	fdo
赌	qyd
钻	cnz
蛮	zvm
矮	avx
唉	oqa
堡	doh
馆	nlr
宜	luy
姿	cyx
爽	mii
堪	hql
焦	urj
劈	sfk
零	eie
薄	gio
扰	kee
艘	pxs
耶	ydy
牧	zkm
益	csa
朗	eou
挣	knk
递	cxn
匆	rpe
肖	bux
婷	xzd
亏	iqk
袍	trd
燃	ser
扯	kxc
叛	yvi
胁	ucs
拒	kps
肚	uhd
皆	lkj
柱	wtz
墨	chm
董	rfa
砸	bpz
莎	gjs
液	jtk
辆	gel
途	wwn
岩	iby
芳	ruf
慰	sov
户	feh
烂	sci
欺	qyq
针	caz
砍	byk
筑	fyp
醉	qta
扔	khr
洲	jiz
协	acs
驾	hij
享	zbx
漠	jem
巫	ytw
莹	rlu
撑	kbk
郑	cmd
眨	qmo
赢	tqy
恼	nzf
珍	uwf
虫	vfc
康	mzp
椅	wmg
俩	del
旅	ume
货	dlq
减	ctj
尝	bic
盈	hia
愧	nkr
邦	ydb
骇	iyh
餐	nin
埋	ham
瑟	uvm
抛	kqc
吻	orp
敲	zni
猫	lrs
侵	dzi
弯	zxw
茫	gtm
悔	nap
喘	oia
穴	lex
玲	uie
勾	rqg
哎	ori
截	atu
舌	fms
肃	zjs
牵	mlz
例	dnv
庭	mcn
彼	hob
宙	lsz
氏	ars
夹	bcj
霜	ers
仗	diz
济	jzv
吕	ool
渊	jvg
卓	nga
甜	frj
笼	fol
柄	wji
嘉	fch
诡	end
姆	xpm
脖	uab
爹	lnn
霍	euh
抹	kxm
艺	roy
倩	dpu
秒	vjm
昂	gad
踢	ygr
哀	zea
末	xjm
奉	phf
劝	icq
腹	uak
钢	cpi
宏	lhq
爪	smz
挤	kzv
泽	jih
鸿	jyt
核	wyh
侠	dbc
猪	lyz
疾	maj
瓶	cpp
僵	djj
乘	vcl
寂	lji
粮	geo
聪	ycv
诱	evh
懒	nwq
搭	kro
潮	jau
鹏	uut
魏	vxr
咐	odo
鸡	itj
肤	ubf
薇	rfp
弥	xnj
瓦	pjw
央	dfy
勉	nrc
川	imc
屈	sfi
耸	tys
匹	prp
尺	mvc
喂	ose
丧	ace
悍	ngh
悬	uqv
拾	kwo
晴	gpu
亿	doy
讯	eoa
溜	jks
魄	kkr
帕	zkp
括	kfk
孟	bam
乔	mmv
怔	njx
蕾	res
搜	kxs
诗	eho
偶	dsp
均	hrc
童	fat
覆	qhk
厌	vme
悦	ncr
载	atg
掠	kzj
垂	fnc
琪	uqq
泄	jfx
霞	esi
港	jnd
袁	hoe
臭	umc
衡	hne
构	wrq
肌	upj
词	eoj
纤	afx
票	qip
诀	edj
饰	naz
噬	ofy
宠	loc
脏	umh
袖	tsx
键	czn
穷	lcq
泥	jsl
驻	itz
眸	qqz
航	ptp
辞	ffc
乡	amx
催	diu
宿	ldg
慎	nas
魅	krx
撕	kqe
逆	ctn
凑	cpm
缝	akn
歉	czy
授	kbi
甩	uls
映	gdy
岸	ivh
凰	pku
唱	ogg
奸	xhj
陵	dhk
崇	ili
枚	wkm
读	eal
暖	gbi
扩	kmk
狮	ljz
瑶	ubz
沿	jpo
渡	jmi
稀	viz
搂	kgx
恋	zvl
捏	kgh
饶	ntr
吩	osk
笨	fwj
返	vin
赖	woq
斥	eec
贤	viq
煞	nkr
询	erg
斜	wwl
撼	ktv
眯	qgm
铺	cip
咳	oyk
浅	jjt
尬	ewv
尴	evf
齿	xwf
洒	jqs
督	niq
奖	cnm
卑	xmb
染	jqw
促	dyc
弗	xvf
娅	xky
麽	mwq
泛	jmo
契	ykm
酷	qzo
罚	qev
络	akl
埃	hqa
课	egw
屠	syt
祸	toi
汇	jph
疗	mvk
赐	qgr
刑	pvx
夸	miq
雕	phu
检	wwb
祥	tpx
俗	dsb
俱	dus
摔	kta
屏	scp
麦	pkm
闯	yic
予	qdy
矿	bmk
恒	njj
郡	zmd
呜	otw
疲	mop
迈	bon
寸	ojc
详	epx
亭	zdt
巡	inx
滋	jca
葛	rrl
婴	qqx
录	zpl
涛	jyo
冠	lvo
枝	wai
翅	aiz
窜	lyc
昆	glk
婉	xld
妃	xdf
矛	qdm
蝶	vfw
瘦	mxs
编	afa
俏	dbu
贪	iqt
繁	akj
绵	akz
棋	wqq
斧	lef
裹	tge
姜	pxj
氛	tsk
後	hak
乾	aao
拨	kxb
慈	cav
瞒	qre
嫣	xjq
咕	oug
屑	sbu
铃	cie
辱	veo
雀	juq
冯	cif
允	qry
樱	wqx
愈	wuv
宾	leb
晰	gwe
掏	krz
措	kng
啪	okk
誓	kee
农	zen
糟	gng
驶	ioi
捉	kyz
祝	tor
朕	ucm
咯	okk
扮	ksk
淫	jbc
鼠	xzs
畏	sew
羊	pey
驱	ipi
恰	nwo
璃	uzp
芙	rbf
烁	saj
岚	ipl
梯	wcx
裁	ate
韵	irc
咽	osm
辕	ghe
夕	nmx
涯	jva
卢	nsl
碍	bgo
幅	znf
扇	fzs
愕	nzq
芸	riy
哇	oaw
润	jyu
崩	iuu
县	uqx
杖	wiz
汤	jhp
翠	zta
健	dzn
箱	frx
恍	nbr
骷	quk
捕	kib
育	tuy
猴	lsa
遮	mrn
泡	jrd
麟	fgl
扣	kok
鼎	qii
溃	jvq
娃	xaw
髅	qgx
逍	bun
述	wen
豹	lre
评	ehc
献	zce
涂	jww
序	mqd
铜	cpj
饮	nyy
灾	lsz
湿	jgk
冬	kcd
贫	skq
汹	jif
党	bor
棒	wph
贯	pqg
串	yoc
丛	tjc
昌	ggc
棍	wgl
嫁	xll
弘	xqh
肥	ugf
穆	vkf
挖	klo
阔	yjf
跌	yad
丑	pvc
赚	qcz
披	kop
漆	jwp
奏	pjm
贺	hqh
喉	osa
酸	qqk
捷	kjx
卧	pfn
凄	cax
割	lov
违	idn
役	hry
坛	hit
砰	bhc
筋	fuc
裸	tgw
井	rjj
涨	jxx
沐	jwm
仓	wdc
巍	ixr
宴	lgx
饿	nkt
鞭	zdi
馨	hrg
瓜	smg
骚	iiv
匪	pyf
耻	yxc
妄	txw
肆	mzh
宛	lnd
裤	tmg
蠢	pvv
龟	ngl
妥	bxt
霆	ecn
雯	ezw
吵	ojc
驰	ikc
嫩	xwk
审	lgf
戈	tjg
款	hiy
桥	wmv
诧	elr
晌	gco
勃	abc
搬	kpr
仆	dnp
漏	jse
械	wtr
彭	fcf
盔	hsa
灌	jru
桃	wcc
黛	scd
黎	vrp
饱	nrd
欠	ymq
抑	kad
疆	xhj
嘶	oqe
辣	fwo
纠	anj
签	fwb
购	qrq
镖	cqi
揉	kqw
愚	spv
勤	rpc
誉	bse
鄙	osd
衫	tfs
珊	uis
弩	xix
呈	ouc
腕	uld
怡	nqo
坠	dwh
腥	ugp
培	hfo
牲	zmp
窝	loi
障	dia
锦	ckz
蓉	rlb
拢	kol
瞳	qfa
麒	flq
析	wex
脾	uxp
涩	jkx
蓦	eim
铠	cid
嘲	oau
毅	flr
僧	dcg
尉	sio
寺	hos
链	cgn
邀	kkn
企	wxq
蜜	lvv
骤	iip
趴	ysp
频	xjb
挨	kqa
蒋	rco
卿	aod
植	wau
刷	szv
厂	vjc
歪	sjx
嚣	zbz
琼	uzj
耍	bax
龄	xfe
拟	kjn
崖	iva
寨	lnw
伐	dtf
丘	emq
柯	wgk
磊	bbb
晋	kgj
艰	ioj
竞	for
碗	bld
慨	noe
涉	jxj
艇	pcn
谨	erp
荷	rdg
跨	ymq
浴	jsb
舱	pwd
颠	asb
趟	xbp
盒	woa
撇	kck
骄	imv
逊	bjn
坑	htp
柜	wps
摧	kiu
崔	iuc
幼	acy
愁	vsv
仑	wll
姨	xmx
踩	ybw
谅	ezj
坤	hgf
绑	ayd
锤	cfn
哑	oky
贾	qqj
宰	lfz
乳	bbl
陌	dbg
惠	hgv
竖	vif
销	cbu
叮	odd
访	euf
虹	vyh
绽	alx
沾	jnz
添	jjj
沃	jmm
挽	knr
迦	hnj
舟	pmz
堵	hyd
鹿	fll
纱	ajs
巾	zfj
荆	rpv
薛	rrf
绩	apq
捂	kvo
枯	wuk
腐	mdi
兔	xmt
凛	cti
夷	mxy
梵	wpe
哗	ola
绳	aol
靖	fpu
搏	kio
斌	zjt
颈	hyb
筹	fyo
逝	ken
厨	vjo
辅	gif
逗	jon
藤	rup
盼	qsk
咦	omx
尹	zmy
呃	ovd
芬	rsk
狸	lal
矩	aps
憾	ntv
膝	uwp
雁	vdu
胳	ukg
咧	onv
沌	jrf
於	uwc
墓	ehm
畅	gfh
擅	ktj
冻	ctj
摊	kiu
黯	cia
泣	jfq
楞	wqu
叉	iec
籍	fxg
牺	zqx
敖	rja
哄	ons
铭	cno
霉	eap
躬	exg
淋	jwl
膊	uio
嫌	xcz
歇	gly
捧	kph
痒	mpy
塌	hgz
嚷	ote
涵	jvf
旨	lgz
灿	sic
摄	kyi
削	buv
茵	rsm
嘟	oyd
匕	lmb
膛	ubh
拱	kns
肢	uai
眠	qdr
珑	uol
伪	dcc
斤	emj
逛	lun
惶	nku
励	vbc
儒	dea
陡	dxd
仲	dyz
瞄	qrs
哨	obu
羡	pcy
掀	key
辽	vkn
沟	jrq
墅	aqh
汽	jtq
档	wbz
隶	zpl
描	krs
俘	dbb
蜂	vky
呐	oin
哲	keo
卒	tta
赔	qfo
裙	tzo
哮	oyb
寿	yos
攀	wwk
杆	whg
旺	guw
寇	lvn
吾	vow
篮	fva
狄	lsd
储	dey
鉴	vfc
嘀	ozu
虏	fcl
嚎	ozl
赋	qjt
隙	djj
炉	sfl
呻	ogf
殷	vzr
污	jiq
辩	fef
篇	ffa
嗓	oiw
吊	ozd
播	kms
颊	bcb
偿	dbi
冤	lxy
耿	ysg
俯	dmo
俄	dkt
躁	yow
狞	lld
嗔	oas
廖	mzf
罕	lhh
狡	ltl
溅	jqt
蹲	yco
焕	snm
缕	agx
嘎	obt
烤	syq
渴	jgr
篷	fkn
乏	mof
擒	kwp
棠	bow
粒	gfl
祺	tqq
惩	hjv
患	oov
谦	ecz
汪	juw
押	ksy
辨	fvf
蛛	vxz
歹	njd
蕴	raa
沸	jxv
遣	vrn
陶	drz
迁	fnq
版	ivi
咆	ord
彷	hup
囊	aoe
劣	jcl
芝	roz
潇	jrj
鳞	xgl
甫	ijf
逢	kyn
玫	ukm
狈	lqb
邓	idd
侦	dnq
炽	sos
竭	fgr
讽	epf
挠	ktr
拓	kbt
戮	zft
订	edd
苟	rro
娶	yix
蔡	rei
丸	qew
佐	dhy
宅	lmr
厢	vrx
驳	iii
拐	kyg
昭	gko
弦	xax
淑	jni
叠	iiu
俞	wuy
辜	ufg
兼	czz
吱	oai
腻	uti
础	bfi
兮	sqx
琉	uti
蓬	rkn
厮	vqe
坡	hop
咪	ogm
朴	wnp
妍	xpy
胎	uqo
刮	fvg
苗	rsm
廊	med
遵	con
蜀	qrv
倭	dvx
浸	jzi
滞	jcz
梭	wqk
湾	jzx
韦	idw
玻	uob
禀	tsi
茹	rxo
敛	wbk
澜	jyw
聂	yii
疏	vxi
瞎	qlo
豆	joc
溢	jca
犬	meq
廉	mcz
潘	jms
嗦	oaj
祈	teq
灼	sre
瞥	ckq
斑	uzu
顽	vbw
兹	caa
糕	gpr
昊	gjm
锅	coi
缚	aio
妞	xpn
匠	pej
魁	krl
鹤	lut
绯	ayf
谎	eri
榜	wfu
碌	bzp
拂	kxv
壶	hlk
昧	gxm
遁	van
蔽	rzk
庙	msm
蹄	yfz
茜	rqx
腔	uly
堕	dhh
耽	yzl
硕	bbs
壳	hlp
彪	fpf
肠	uhp
钰	cue
岭	iie
嗡	osz
栋	wtj
葬	rnr
冉	phr
挪	khd
鞋	zax
蹦	yiu
柴	xlw
蔓	rgi
陀	dll
姊	xmq
啧	opq
妨	xuf
窃	lrk
阎	ynx
盆	ska
焚	wsf
矢	ams
携	kuh
钉	cdd
帘	lzl
俺	dml
嗤	otv
萝	rqn
沧	jwd
循	hvq
搅	kbl
渺	jqj
兀	jrw
狭	lbc
戟	aat
申	gfs
翘	trz
嘱	osp
拆	kee
津	jzh
贱	qjt
汝	jxr
暇	gsi
愉	nwu
侄	dfz
棵	wgw
谭	eqa
轨	gqg
蚁	vei
啥	owu
媒	xrw
噗	oke
锻	cyr
赴	xnf
诈	ehz
巢	igw
捡	kwb
哟	oar
衷	tye
吁	ohy
彦	fmf
渗	jqf
峡	ibc
涡	joi
禅	tca
氓	tdr
浆	cnp
租	vuz
阅	yco
掐	knx
帽	zgq
揭	kgr
妒	xfd
毙	lnl
寞	lem
孝	ybx
乙	ovy
贸	akq
革	zjg
喔	osf
憋	ckv
蓄	ras
坎	hyk
舅	xsc
絮	xoj
烛	svz
歆	iyx
胞	urd
翰	aaz
颖	lvb
彤	ptf
唔	ovo
垃	hfl
圾	hhj
尧	tjr
旭	qgx
寄	lmg
喀	olk
遂	cln
阱	drj
泊	jkb
妾	fxq
瑰	ukr
虐	fzn
潭	jqa
祀	tds
逻	qnn
璇	uux
税	vcr
嫂	xxs
填	has
蛟	vtl
怯	nhq
滔	jbx
弧	xsh
惫	ksv
煌	sku
雍	tmu
衍	hje
笛	fsd
庸	mzu
兆	ccz
咚	okc
暮	egm
卜	nfb
裳	boe
沫	jxm
蝎	vgr
寡	lbk
蚀	nvs
枉	wuw
粹	gta
澡	jow
昔	ngx
摘	kzu
瀚	jwz
寝	lci
熙	pdr
舜	bnl
售	uos
栽	atw
胧	uol
贞	nqz
诅	euz
滩	jiu
韧	idk
倚	dmg
睹	qyd
栈	wjt
蝠	vnf
桶	wqb
卦	ang
臀	sru
狰	lnk
姚	xcc
雇	fug
署	qys
狙	luj
泼	jxp
诛	exz
朦	url
栏	wci
筒	fpj
哧	ohz
溪	jbm
册	imc
窥	lbl
湘	jrx
犀	spz
舔	fjj
剥	zpv
磁	bca
惕	ngr
旷	gmk
佑	dho
歼	nfj
兜	asr
窟	lsi
枕	wzl
囚	swq
裴	yte
胀	uxz
楠	wzc
觑	fkl
擂	kes
拽	kgl
捣	kti
蕊	rvv
巷	nsd
乞	aoq
谱	ecg
蚩	tjv
哩	oal
琢	ule
垒	qqh
胃	suw
虞	fom
绣	avh
衰	toe
扁	fab
菩	rfo
颅	nsb
骆	ikl
抄	kjc
菁	rpu
纽	apn
贡	yqg
噢	ocm
桓	wjj
绮	amg
戚	tnj
惟	nuw
慑	nyi
罡	qjx
喧	olj
衙	hve
瑜	uwu
岗	ipi
侃	doi
祷	tyo
萍	ghc
剂	zvv
莽	rmr
诞	emn
轴	gsz
嘘	ofk
烫	jhs
咙	ool
鞘	zbu
丞	vpj
剿	iwv
孽	rrb
淘	jrz
翎	iez
翁	sqz
恕	xov
衬	toc
倦	dpd
揽	kfl
疚	mne
轿	gmv
秃	vpt
猾	lqh
钦	cyq
嗜	oyg
掷	kcd
藉	rxg
鸦	jdt
陨	doq
熬	rra
窍	lyq
郝	hzd
芷	rxz
咖	ohk
勋	oqc
铸	cyo
叨	okd
乍	hmz
磕	bha
扳	kvi
霎	efx
姥	xyl
棺	wlr
奢	mys
辟	sof
叙	wwi
畜	asx
嫉	xma
蜘	vao
搁	kyk
钥	cuy
陋	djl
茅	rqd
倏	dkm
瘫	miu
菊	rrg
匙	gxl
翩	faz
倘	dbp
擎	rkk
趋	xnz
窄	lhz
峻	iqk
啡	oyf
嗽	owy
醋	qng
酥	qvs
伺	doj
恳	ovk
粘	gnn
哆	onn
绞	atl
绷	auu
丐	jnq
渠	jpw
娱	xom
佘	wis
淌	jbp
履	shk
塑	cuh
症	mjx
衔	hce
蔑	rqt
禽	wzp
傀	dkr
蛊	vag
炀	shp
捞	krc
蒸	rvr
缄	atj
嗖	oxs
炫	sax
眩	qax
歧	xai
邱	edq
挟	kbc
帆	zpe
莺	rlt
渔	jxy
敞	bpk
绰	ana
淳	jzb
厥	vcy
瞟	qqi
霹	esf
疤	mgb
柏	wkb
徽	faj
讪	eis
猿	lhe
沮	juj
眶	qpu
页	bjy
卸	axd
宵	lbu
惭	nge
菱	rhk
踹	yia
肿	uyz
萱	rlj
斐	yzf
钩	crq
瓷	cyp
雳	evc
茂	rtm
肺	ujz
届	ssj
鹫	zet
碑	bxb
儡	dss
蝉	vca
夭	mmy
娟	xou
曰	gfy
淮	juh
拘	kro
搓	kpy
捅	kqb
豁	lob
亨	zvk
荐	rcb
漩	jux
捆	ksw
沼	jko
迭	and
侮	dap
叱	olc
槐	wkr
迸	cpn
扛	kyk
屡	sgx
鲍	xrd
脊	ccu
忖	noc
婢	xxb
栗	qwl
驼	ill
贩	qvi
芦	rfl
拎	kie
彬	wfb
姗	xis
淹	jml
怠	qov
钧	crc
嗅	oum
樊	wwm
弛	xkc
霓	exr
揍	kpm
喽	ogx
汁	jaz
惮	nca
邻	ied
蟒	vrr
衅	may
瘾	mdv
账	qxz
览	vfl
妩	xhl
厦	vbk
妆	cxz
芊	rfq
抿	kdr
喻	owu
吏	iol
澈	jtk
砖	biq
僻	dsf
倪	dxr
挫	kth
杏	wox
襄	tze
桐	wpj
矣	qay
噩	uzz
揪	kvs
拧	kld
燥	sow
郊	tld
喇	owv
沦	jwl
蚂	vim
阮	dvr
帖	znt
戬	kgt
铲	cfm
孕	hby
跺	ypw
巅	isb
敦	zbk
婪	wxl
蹈	ybx
蹭	ycg
株	wxz
凹	ffa
婿	xvu
嬉	xfo
盐	hna
冀	cls
膜	uem
剪	cuk
鞠	zrg
桂	wag
盏	jta
襟	twi
逞	oun
棘	wpw
焉	jqr
跋	yxb
呕	opi
稚	vuz
嵌	iry
熠	szk
颓	vpb
妓	xai
穹	lxq
邵	kod
涣	jnm
债	dpq
梧	wvo
勿	rpw
墟	hfk
焱	sss
桩	wmh
脯	uif
镶	cte
拭	kty
忿	skv
撩	kmj
涟	jgn
谍	efw
拇	kpm
瑾	urp
疫	mry
掘	ksi
梨	vvw
窒	lfz
朽	wqx
奕	tzm
涅	jgh
顷	lbq
咋	ohz
酬	qic
琦	umg
蝙	vfa
吭	otp
僚	dmj
镰	cmz
砚	bly
瞅	qvs
饥	npj
邸	ard
漾	jpp
婕	xjx
胤	rau
呸	osj
译	eih
峙	iho
寥	lzf
凸	fft
垫	phd
肋	ucl
噜	oxg
漓	jzp
剔	gpv
猩	lgp
梳	wti
峨	ikt
熄	suv
睿	nlq
禹	mvp
址	hxz
蝴	vuu
萌	rgu
瞻	qne
眷	pqj
蹬	yec
绘	awi
龚	ons
岔	ski
唬	ofp
飙	mmp
驭	iiy
漪	jmg
侥	dtr
肘	uoz
侣	doo
熏	fcx
螺	vsj
聘	ysq
唾	ofn
幢	zfa
揣	kia
坊	huf
湛	jql
谊	elu
箫	fzj
沛	jjz
垮	hmq
妲	xgj
鹃	out
翡	yzf
琐	ubq
髓	qhn
讥	epj
裕	tsb
薪	rfe
毯	fss
骸	qyh
癸	ejm
苹	rhc
匿	prh
脂	ulg
玑	upj
澎	jff
枢	wpi
懈	nkz
宪	lzr
搀	knc
皓	kzo
悸	nvb
嗷	ora
跄	ywd
镯	cqr
膨	uff
憨	vkv
瓣	fsf
泻	jlq
踉	yeo
黝	cac
葫	ruu
渣	jwj
麾	mwf
酿	qeo
詹	nve
沁	jvq
眈	qzl
畔	syp
懊	ncm
熔	slb
筷	fnd
霖	ewl
综	ali
傍	dfu
瑕	usi
刁	ojd
嚓	oli
惚	nrv
践	yjt
兢	urr
尿	spn
秉	vzb
伞	wca
崆	ily
棉	wkz
媳	xuv
坟	hzf
鹅	ktt
瀑	jgp
鲸	xzj
逮	zpn
糖	gmo
缉	aoy
稻	vbx
暧	gbi
奎	mak
绸	aph
隋	dhu
狩	llo
湃	jjy
叽	opj
饼	ncp
靡	mwy
锥	cuz
碟	bfw
拙	kfi
簇	fua
蝇	vol
蚕	jmv
叩	odk
咸	tjo
亢	tpk
澄	jec
骏	iqk
辖	glo
媛	xbi
姻	xsm
扒	ksb
赠	qcg
秩	vaz
朔	ctu
倔	dsi
嚼	obo
卵	acd
胶	utl
绚	arg
镔	cle
蚊	vzw
唧	ood
炯	spo
罐	zru
浊	jvz
冶	cqo
讳	eid
杭	wtp
弊	ckr
戳	zut
禄	tzp
斋	zba
搐	kas
炙	nsz
佬	dyl
聋	oyl
厄	vde
凳	ejp
鲨	jjx
驴	ifl
盲	tqm
锢	csu
锡	cgr
诏	eko
伽	dhj
铮	cnk
缭	amj
鸭	sty
捶	kfn
唰	osv
搔	kiv
滥	jfa
恙	pvy
谜	egn
啃	oxu
啼	ofz
驯	iix
匣	psx
悯	nyz
鸾	ztl
杉	wfs
煜	sgf
拣	ktj
拯	kvj
偎	dse
呛	owd
绅	agf
屿	isy
煮	yrz
璐	uyk
冈	pig
甄	qhp
匈	rif
钓	cre
咔	onc
笙	fmp
桀	nlw
蜥	vwe
囔	oae
缴	akk
喳	owj
泳	jep
睬	qbw
祟	fii
崎	img
谣	ebz
晖	glg
炭	ihs
忑	cvt
栖	wqq
娴	xyw
忐	njv
榕	wlb
堤	hgx
哽	oji
烬	smc
炒	sjc
棱	whk
肝	uhg
靴	zdl
痞	mso
阀	ydt
缪	azf
赦	hzk
殖	nau
纲	api
璧	sfu
厘	val
泓	jxq
涕	jcx
壤	hte
懿	hcv
闺	yag
浇	jtr
匀	rcy
棚	wuu
娲	xoi
蔚	rso
稽	veg
虾	vcx
劭	koc
茨	rcy
戾	fme
橙	wec
厕	vqv
捐	kou
瘟	mga
舵	pll
芯	rvx
晒	gqs
烙	skl
驸	ido
亵	tep
颂	sqb
钝	crf
窘	lmo
懦	nea
稷	vsk
赎	qal
袅	tte
庶	mrr
腮	usv
绢	aou
葱	rrv
溶	jlb
榻	wgz
吨	orf
貂	lko
哉	ato
娥	xkt
悚	nwo
虔	fzq
蹙	tny
婶	xlf
屎	sgs
磋	bpy
殆	nqo
诩	ezx
蠕	vea
偌	dro
拚	kqr
骼	qkg
觅	blm
旱	ghh
裔	tep
昱	gfy
冕	gnr
屯	rft
惋	nld
萎	rvx
苑	rnd
枭	twx
惺	ngp
砂	bjs
殴	pir
叭	osb
梢	wbu
缨	aqx
蹿	ylf
飓	pus
峭	ibu
甸	rsd
谐	elk
澳	jcm
聆	yie
腊	ung
缜	aas
帜	zos
昼	mgj
滕	upp
茧	rvj
绫	ahk
汰	jme
皙	wek
踱	ymi
嵩	izo
兑	cor
诊	ewf
葡	rri
筝	fnk
邃	lcn
辑	goy
獠	lmj
昕	gex
蜡	vng
奄	mgl
诵	eqb
腑	umo
悻	nha
憎	ncg
嗨	oap
敷	iuk
庇	mlb
榴	wks
晦	gap
祢	tnj
荀	rrg
慷	nmp
寓	lsp
茉	rxm
咄	ofi
曙	gqy
噪	ozw
吒	omr
缸	zyg
幡	zms
啤	oxp
烨	sla
忡	nyc
粥	xgx
悴	nta
咏	oep
颔	iob
洽	jwo
募	ecm
驿	iih
藩	gms
靶	zgb
谬	ezf
憔	nur
邹	nzd
痹	msr
绊	ayb
酋	ceq
框	wpu
茄	rhq
挚	pkz
萄	rrz
恬	nft
聿	zhy
檀	wtj
凿	kcf
璋	uia
钞	cjc
褐	tgr
蟹	nkv
鬟	mfe
铛	cbz
曦	gpt
崽	isv
胯	umq
璀	uiu
菇	rxu
眺	qcc
瘩	mro
璨	uig
抡	kwl
斟	qll
褪	ton
涎	jmn
勺	res
溟	jls
疙	mao
坪	hhc
猥	lse
塘	hmo
揖	koy
逾	wun
冽	cnv
遏	grn
芽	rjd
裘	pee
徊	hso
函	vpf
槽	wng
蟾	vne
睫	qjx
珂	ugk
嘭	off
蒲	gip
煎	cur
庚	mzw
荫	rdu
稿	vzo
徘	hyp
蛙	vaw
睽	qem
廓	mzd
滨	jle
彰	iaf
锵	cno
掺	kqf
缰	ajj
芭	rgb
嗒	oro
嘈	ong
暄	glj
琅	ueo
萤	rlv
旬	rgx
翱	kaz
栅	wiz
缈	aqj
猝	lta
魇	vmr
攒	kzq
蜴	vgr
鞑	zmn
窿	ldp
扈	fog
蜷	vpd
秽	vin
崛	isi
谕	ewu
袱	tme
瑚	uuu
磅	bfu
缔	afz
攸	dfk
缥	aqi
惬	npb
撅	kvy
钮	cpn
阙	yct
鸽	wot
葵	rem
曳	glm
蔼	rer
礁	bur
苛	rgk
佗	dll
庐	mfl
珀	ukp
稠	vph
娉	xsq
嗣	oao
饵	nye
耕	xrg
肴	ihu
渎	jal
嵋	isq
伶	die
瑭	umo
懵	nrq
饷	nco
韬	idx
恃	nho
浦	jip
邢	pdx
咻	odw
隧	dcn
贷	sqd
滢	jru
掳	kfc
颁	skb
芜	rhl
檐	wne
祯	tnq
吝	zol
蘑	rmb
咫	mos
茬	rch
怦	nhc
缀	aii
扼	kvd
唠	orc
趾	yxz
殃	ndy
噼	osf
掂	kmn
啐	ota
羌	plq
畴	syo
枷	whj
捺	kmi
禾	vmh
绒	ath
邮	sdy
辙	gtk
籁	fwq
煽	sfz
戎	thr
糙	gzn
漱	jwy
竿	fhg
瘪	mul
矫	amv
汀	jdt
吆	oay
怅	nxc
攘	kte
叼	ooj
昵	gsl
烽	sky
猖	lgg
芥	rwv
紊	zaj
甬	qby
跷	ytr
靓	pul
栩	wzx
簌	fwy
寐	lix
壕	hzl
侈	dnn
嫡	xzu
黏	vpn
亩	tsm
酣	qrj
舆	xgs
痊	mwu
娆	xtr
侏	dxz
佯	dpy
锣	cqn
佼	dtl
羲	pqt
棣	wzp
鳄	xzq
惘	npc
霏	eyf
媲	xcl
蔷	ras
篝	fnp
蛤	vwo
虬	vlq
荧	rls
舷	pax
螂	ved
溺	jxx
羿	zry
巳	dvs
仕	dhs
攥	kfj
桦	wla
氧	tpy
殇	nah
捻	kiv
胄	suz
臧	tlb
萦	rlj
漉	jfl
骋	isq
券	pkq
贬	qmo
瑛	urd
迂	hny
晟	gto
雏	nzu
勘	qlc
煤	srw
坞	htw
衮	tse
蓓	rdo
蹂	yqw
蜒	vmn
忒	tvt
晏	glx
牡	zhm
札	wlz
缎	ayr
膏	zou
屹	iao
肮	utp
哒	omn
煦	grr
棕	wli
糜	mwg
瞠	qbh
筱	fdk
躏	yry
臻	fpv
淤	jwc
瀛	jtx
蹊	ybm
孰	zbq
沪	jfh
浙	jke
毗	slp
呱	osg
磐	prb
矜	qdi
幺	avy
俨	dkm
琥	ufp
胴	upj
暑	gys
雌	xlu
锯	csu
硝	bbu
酱	cnq
喋	ofw
箍	fkp
婧	xpu
玺	nju
羁	qzi
骁	itr
拈	knn
迢	kon
衲	tin
呗	oqb
钵	cwj
鬓	mfs
剖	fov
蜿	vld
鞍	zlx
伫	dlj
恤	nma
铿	cih
鸳	ndt
蝗	vku
茸	ryr
赃	qmh
谴	evn
邑	ogy
俐	dvv
吮	oqr
刊	hvk
钳	crj
亥	yeh
噎	ohc
巩	ype
驹	iro
薰	rfc
踌	yyo
饕	ofn
矗	auu
躇	yry
蹑	yyi
弑	iwt
崭	ige
褚	tyc
湮	jqh
踞	ysu
恺	nid
鸠	qtj
邯	rjd
渍	jpq
汴	jtn
蜈	vom
惦	nmn
谑	efz
砌	brk
辎	gis
贿	qhu
癫	mab
诫	etr
赘	rqz
伎	dai
铐	cyq
诣	elg
匡	puk
岌	ihj
旎	usl
锈	cvh
桅	wnd
鸯	dty
鲲	xgl
莞	rlv
玮	uid
剌	wov
茱	rxz
祁	tdq
奠	cmd
岱	sid
辫	faf
闵	yzm
燎	smj
椒	wni
缇	agx
惴	nia
疮	mwd
酌	qre
窖	lzo
邬	tdw
呦	oac
顼	ubx
岐	iai
捋	kbo
飕	pxs
楮	wyc
帷	zuw
笃	fid
噔	oec
骰	qrt
鄂	zqd
珏	uue
汩	jgg
鑫	ccc
嘤	oqx
掰	ksk
峦	zil
冢	lle
瓮	sqp
唏	oiz
蟆	vem
掣	zvk
隘	dca
瞩	qsp
茗	rno
哝	oze
拷	kyq
蚣	vsq
慵	nmu
洼	jaw
牟	qzm
娄	gxl
敝	czk
孜	bkz
龌	xfh
餮	nwn
窦	lal
烘	sns
咣	obr
飒	fps
咎	kno
憧	nfa
逵	hsn
闽	yvm
啷	oed
睨	qxr
铅	cpo
楷	wlk
绎	aih
皎	ktl
龊	xfy
阉	ymg
黠	cfx
隼	uas
菌	rsv
钗	cie
诶	eqa
杠	wyg
靥	vmq
饲	noj
蜃	vev
筛	fvz
淼	ppp
粪	gns
颍	lpb
喏	oro
苔	rqo
啬	acs
闸	ysz
憬	ngj
伢	djd
酝	qiy
柬	wqj
啄	ole
窑	lzy
旖	umg
喵	ors
寰	lqe
羔	prg
膳	upo
缅	abq
垣	hjj
筠	fhr
乒	emp
榨	wlh
笈	fhj
瞑	qls
剁	pwv
奚	bam
兖	tsr
庵	mml
瓒	uzq
孺	bea
梓	wfz
杵	wzc
扉	fyf
诲	eap
坍	hpt
咂	opz
噤	owi
峥	ink
纶	awl
壑	nih
殉	nrg
辐	gnf
蜕	vcr
唆	oqk
阖	yhq
谛	efz
穗	vhv
琶	uug
螳	vbh
盎	daa
褒	tde
贲	arq
毋	pvw
淬	jta
藻	gjw
粟	qgs
袜	txw
佟	dkc
簸	fqo
苇	rid
醇	qzb
枣	wpc
拗	kac
椎	wuz
橡	wxx
蹋	ygz
遐	ssn
拌	kyb
馋	nnc
橘	wqp
霭	eer
啜	oii
撮	kgi
馒	ngi
纬	aid
嬴	txy
潺	jsb
筏	fdt
宦	lpf
娑	jjx
鹭	ykt
玎	udd
抉	kdj
匍	rip
蕃	rms
恻	nqv
乓	eep
苞	rrd
胥	vxu
帛	kzb
驮	imt
痪	mnm
碾	bse
陕	dbc
嬷	xmq
髯	mfh
嫦	xbz
耷	myd
阑	ywq
迳	hyn
弈	tzr
眦	qxl
侬	dze
娓	xsf
噘	ovy
炬	sps
沥	jvc
曜	gzu
禧	tfo
陇	dol
咛	old
砾	baj
竺	fiz
胭	usm
涧	jyg
墩	hzk
呲	oxl
篡	fqq
昙	git
蟠	vms
旌	ump
睦	qhh
羹	prm
琵	uul
咀	ouj
馅	nnx
讷	ein
磷	bgl
孵	abb
濒	jxb
亘	jgj
簧	fns
诬	eyt
擞	kgk
魃	krx
瓯	pip
曝	ggp
删	ivs
徨	hku
宓	lvm
桨	cnw
楣	wsq
铎	cih
剐	oiv
匐	rnf
腆	ups
谏	ewq
粼	gni
阐	ycg
婀	xdg
邺	kdy
纨	aqe
辗	gse
卉	arh
偃	dpg
鹊	ngt
槛	wfa
荼	rww
锭	clx
瘴	mia
瑙	uic
皂	krz
踝	ygw
铳	ctr
锄	cuc
剃	cmv
吠	ome
蛰	pvz
琰	uss
叟	xms
缤	ale
颌	wob
珈	uhj
浏	jzv
卤	nsi
匾	pfa
飚	pss
刨	rdv
杞	wdq
馁	nbx
瘸	mhi
榭	weo
绛	akl
姒	xjs
殒	noq
瓢	qis
窈	lac
栓	wwu
婊	xpe
譬	sfe
谄	enx
垠	hoy
壹	hlc
呤	oie
烹	zvr
靳	zej
丕	sjp
蕉	rur
隅	dsp
礴	bgo
嫖	xqi
炊	syc
珞	ukl
挲	jjk
蛾	vkt
膺	mdu
猬	lsu
潞	jyk
筐	fpu
骜	ria
俑	dqb
鳌	rxa
稣	xvs
蒜	rii
窕	lcc
腋	utk
魑	krz
芮	rir
簪	feg
麴	wkr
黔	ciq
垢	hxo
屉	sft
馀	nww
笋	fzm
轼	gty
汲	jhj
迥	pon
垄	ohl
弼	xbx
沣	jyf
稼	vll
纣	aoz
郢	oud
藐	rlr
寅	ljs
戍	tes
簿	fjo
拄	ktz
泌	jvm
渲	jlj
嚏	oax
呓	oro
篆	fpl
斓	zyw
鲤	xal
熹	fcr
圭	ajg
锏	cyg
螃	vfu
茎	rhy
龇	xfl
丙	jib
皑	kid
睚	qva
撂	ksk
惆	nph
鸥	pit
嚅	oea
炳	sji
谧	eva
篱	fzp
跚	yis
渤	jac
螓	vpv
矶	bpj
梗	wji
岑	iic
槌	wrn
糗	gum
滤	jfv
蛆	vuq
拴	kwu
晁	gcc
犷	lmg
潼	jfa
灶	shz
踵	yfa
坝	hqb
髻	mff
嗲	oln
袒	tgj
晔	gla
碳	bis
麓	wfl
渝	jwu
涔	jiv
卯	adm
菡	rvf
泯	jdr
撬	kff
羚	pie
抠	kpi
嗬	org
馈	nvq
骠	iqi
凋	cph
赂	qkl
噌	ocg
鸨	lat
苜	rqm
幌	zgr
褥	tvo
嘹	omj
袂	tdm
荤	rlg
囤	srf
裆	tbz
盅	yaz
醺	qfc
萃	rta
赧	hzi
婵	xca
氤	tsm
腼	ubq
梆	wyd
涸	jsu
釜	lhc
镭	ces
椭	whu
祠	toj
硫	bti
晤	gvo
隗	dkr
痉	mhy
笺	fjt
饺	ntl
睐	qxc
峒	ipj
涤	jkw
俸	dph
玟	uzw
谪	ezu
渥	jsf
劾	ych
氲	tga
挛	zkl
蹒	yre
霈	ejz
舫	puf
鳅	xvs
苋	rlx
琬	uld
怏	ndy
嗫	oyi
瞰	qvk
蚌	vyb
溯	jcu
沓	pgt
翌	zfy
蜻	vpu
甭	sbb
唷	otu
藕	rxp
疵	mxl
啾	ovs
绔	amq
毓	api
桉	wlx
癖	msf
蝼	vgx
韶	iko
霁	ezv
蔬	rxi
跤	ytl
甥	mpc
颐	pfb
怂	tvs
炕	stp
咿	ozm
咤	olr
毡	fnz
桔	wfj
鳖	ckx
弋	tjy
撰	kds
晾	gzj
泞	jld
嗝	ojp
霾	ela
蟑	via
臌	uai
掬	krg
绾	alr
獒	rme
璞	uke
臊	uow
臾	xwy
恸	nic
贮	qlj
阂	yyh
岖	ipi
翟	zud
咨	cyo
堑	geh
倡	dgg
忏	nfc
妤	xqd
啵	ojo
殛	nvj
瞌	qha
哐	opu
圃	sip
蛹	vqb
俭	dwb
灸	nes
剽	qiv
缆	afl
橱	wvo
秤	vhc
搪	kmo
嗥	oka
粲	nig
钛	cme
圳	hiz
邕	iog
畿	ats
鹦	qxt
淀	jlx
褂	tan
瘤	mas
忤	nzw
笠	ffl
挎	kmq
渭	jsu
糯	gea
祗	tar
肾	viu
恿	qbv
垛	hpw
鹉	jxt
纺	auf
觎	wul
觊	idl
潋	jwk
猊	lxr
豺	llc
胚	usj
魍	krp
琛	ulw
炜	sid
揶	kyd
鬃	mfi
汜	jds
辘	gfl
雹	erd
玷	und
撵	kbg
颦	xbx
坳	hac
杳	wgy
荃	rwu
揄	kwu
摁	ksv
咝	oaj
辄	gyl
箩	fqn
鹞	bzt
犸	lim
捎	kbu
潦	jmj
蚯	veq
翊	fzy
湄	jsq
芋	rhy
靼	zgj
濑	jwq
郸	cad
啕	orz
粱	jkg
镀	cmi
汐	jnx
榆	wwu
淇	jqq
魉	kre
脓	uze
苯	rwj
赈	qve
觐	rpl
坷	hgk
篑	fvq
哂	oqs
旃	upt
齑	zyv
荦	rlz
裟	jje
辇	bbg
幔	zgi
蘅	rhe
颚	zqb
犄	zmg
惰	nhu
徙	hxx
蚓	vxf
柿	wtz
睥	qxp
讹	edl
嵘	irw
嗵	oqn
暹	gun
悼	nna
罔	pct
琏	ugn
蠡	pvv
囵	swl
骊	ijp
堰	hpg
趄	xuj
宸	lve
垦	ohk
啻	fzo
趔	xnv
魈	krb
麝	flo
摒	ksp
遢	gzn
癌	moi
漳	jia
瑁	ugq
硅	bag
斡	aal
锚	crs
玳	usd
耙	xgb
沽	jug
颉	fbj
湍	jia
袤	tqe
卞	tnb
纰	alp
壬	cmr
褶	tzk
袄	tmm
肇	fkh
犁	vvz
鼾	urh
邋	isn
忻	nex
淅	jwe
侨	dmv
诽	eyf
孪	zbl
倨	dsu
脐	uzv
皿	afm
阗	yau
嘣	oiu
螭	vzp
腴	uxw
骡	isj
恣	cyv
瘠	mcu
噶	orr
掸	kca
谙	eia
愠	nga
谲	eqp
叵	pop
痰	mss
薯	rqy
袈	hte
淄	jis
彗	yyz
恪	nkk
孱	sbb
迄	aon
蔫	rqr
蜗	voi
癞	mwq
遑	kun
噫	oiy
羯	pgr
鲛	xtl
涓	jou
罂	qqz
褛	tgx
揩	klk
嫔	xle
褴	tfa
郦	jpd
潢	jns
镑	cfu
馥	vgk
炖	srf
镣	cmj
瘁	mta
桧	wwi
讧	eyh
迩	njn
涮	jsv
澹	jne
嶙	igl
徵	fuz
蔻	rlv
豚	ult
镂	cgx
轲	ggk
篓	fgx
禺	spj
樵	wur
遽	fln
怵	nwe
孬	sxb
臃	utu
芹	req
挞	kmn
偕	dlk
酆	ycd
臼	xmj
贽	pqz
碉	bph
蒯	ruv
夙	pns
煊	slj
蓁	rpv
掖	ktk
帚	zlz
泠	jie
臆	uiv
粤	cgq
銮	zcl
抒	kqd
偻	dgx
庖	mrd
椰	wyd
琮	uli
匮	pvq
峋	irg
榄	wfl
盹	qrf
轧	glz
诋	ear
夥	gwn
憩	fuv
戛	bqt
瞿	qqu
佻	dcc
遨	rna
阜	raf
镳	cfr
蜓	vcn
鏖	flc
摞	ksj
忪	nsq
噙	owp
夔	cmk
仞	dke
荑	rmx
鸢	tty
洱	jye
姣	xtl
腺	ukp
泱	jdy
捱	kva
跆	yqo
闾	yoo
犒	zzo
琊	ujd
盂	hay
骥	ils
岷	idr
鸶	aat
痣	mhv
闳	yhq
帼	zsu
碴	bwj
芍	rre
犊	zal
蝈	vsu
粽	gli
侗	dpj
喟	osu
傥	dbr
卟	onb
蓟	rxv
馊	nxs
堇	rop
踮	ymn
冗	lpr
倜	dph
蹩	cky
珩	uhe
奂	npm
戌	tjx
鄢	jrd
濡	jea
谀	exw
镐	czo
僖	dfo
幄	zsf
狒	lxv
颛	iab
鹧	mrt
箕	fqj
翦	cuz
摹	ekm
愫	npj
椁	wzb
倌	dlr
佝	dro
萼	rzq
骧	ite
锹	cvs
娼	xgg
燮	ssi
弭	xym
诌	enz
泗	jsr
鸪	utg
洵	jrg
雉	auz
漕	jng
怩	nsl
猷	cme
贰	tiq
汶	jzw
淆	jiu
赣	ikq
钊	cvz
轶	gay
鳍	xyg
忸	npn
喙	opl
筵	fmn
丶	eez
橇	wff
箬	fho
祚	thz
燧	scn
沂	jey
繇	bzj
蕙	rhv
濠	jzl
沅	jvy
莆	rip
砺	bvo
槟	wle
骛	qki
刽	wiv
獗	lvy
睑	qwb
岈	ijd
牒	ifw
艮	ovg
荥	rlp
妪	xpi
诠	ewu
悖	nab
唳	ofm
纾	aqd
浃	jbc
狻	lqk
蚱	vhz
钏	cic
搡	kiw
浣	jlv
谗	enc
麋	flg
钺	ctl
宕	lbd
鹄	zot
砥	bar
杈	wie
呷	osx
撸	kxg
邈	lkn
膘	uqi
橄	wvk
滟	jng
俪	djp
谤	efu
鸩	zlt
怆	nwd
忾	ntk
邝	mdk
缮	apo
汾	jsk
绉	anz
攫	kqi
畸	smg
磬	hrb
蹇	lny
钠	cin
贻	qqo
舀	bxy
恁	dcv
箐	fpu
腓	uyf
铝	coo
赳	xnj
沏	jrk
氢	thy
檄	wkk
坂	hvi
炷	stz
垩	khe
隽	uhj
驽	xii
陲	dfn
泾	jhy
蹶	yvy
哺	oib
磺	bns
匝	pzz
讼	esq
掇	kii
霰	euk
哔	ola
坯	hsj
蘸	rqr
嫒	xbi
苓	rie
遛	akn
皋	kma
僮	dfa
跖	ybz
佞	dix
衩	tie
鳗	xgi
涿	jle
翳	prz
糠	gmp
彝	pgr
荔	rcc
髦	mff
佶	dfj
娣	xcx
胛	usj
铄	caj
诘	efj
濮	jke
浒	jez
敕	wok
逅	xon
姹	xlr
迤	akn
巽	dds
钜	cps
嗑	oha
舶	pkb
仨	dbs
翕	woz
豸	lmz
厩	voe
莓	rap
颀	ebq
锺	cfa
阚	yvy
舄	xrr
孚	bbf
呶	oxi
呔	ome
蜍	vww
貉	lkh
莜	rdk
藜	rvp
肪	uuf
膻	utj
刎	rpv
氅	bkf
聃	yph
泸	jns
阪	dvi
懑	jrv
猡	lqn
圜	sqj
儆	drk
逖	lsn
聒	yfg
邙	tdm
秣	vxm
汕	jis
扪	kym
谒	egr
衾	ite
龅	xfr
戗	wdt
姝	xxs
昶	epg
埔	hip
罄	hrz
蛀	vtz
嗳	obi
绶	abi
汨	jgm
谩	egi
螟	vls
佥	wbq
邂	nkn
竣	fqk
耘	xiy
俾	dxb
沱	jll
蜚	yvf
湫	jvs
焊	sgh
砝	bhq
舐	far
赝	vdq
恹	nvm
蛭	vfz
滇	jas
剜	lnv
昀	grc
缙	akg
鸵	tll
樽	wco
俟	dqa
谆	ezb
裨	txb
蒺	rma
涪	jfo
葩	rkg
诃	egh
鞅	zdy
踊	yqb
氐	are
荏	rdc
淙	jli
蹴	yee
藓	rxp
煅	syr
谡	esk
猕	lnj
浚	jqk
淞	jsq
瘌	mwv
潸	jwu
跛	yob
桢	wnq
坨	hll
俦	dyo
楔	wkm
铤	ccn
犟	xoz
矍	qqi
菠	gob
诮	ebu
笆	fgb
崧	iwq
绥	abx
獐	lia
溥	jio
恫	npj
饪	ncr
殄	nwf
昴	gad
槿	wrp
牦	zfm
馍	nem
砧	bnz
葳	rtj
滂	jfu
绡	abu
鎏	jtc
骓	iuz
醐	quu
囱	ckc
噱	ofl
黜	cfi
哓	otr
祛	thq
抨	khc
绺	ano
咩	opm
醍	qgx
戊	tjw
茁	rfi
佃	dsd
蚤	iev
塾	zqh
谟	eem
釉	mgs
谚	eff
诰	ezo
锟	cgl
灞	jeu
町	sdd
嗄	obk
逡	qsn
葭	rfi
柩	wpn
滓	jlf
跻	yzv
棂	wzs
诳	elu
籽	gbz
囫	srp
锷	czq
碱	btj
奘	ihm
獬	lkz
夯	mch
痿	mvx
痍	mmx
秧	vdy
榷	wlu
忱	nzl
鱿	xee
圉	shc
峪	isb
绌	afi
馗	qcu
酉	qjy
莒	roo
嶂	iia
酡	qll
崴	itj
镌	cuh
殁	nrm
膑	ule
徇	hrg
纭	aiy
脶	uoi
鹘	qtg
腌	uml
叁	qmb
碇	blx
晷	gko
兕	frs
渚	jyz
刍	nzc
痘	mjc
嚯	oeu
莅	rdf
蛎	vvo
龛	woo
谔	ezq
槊	cuw
豢	plh
胫	uhy
仝	wyt
佰	dbg
碜	bqf
殡	nle
绦	akw
闩	yjs
瘀	muc
哞	oqz
蓿	rlg
驷	isr
玖	une
锲	ckm
耒	xjl
鄱	msd
亟	vkj
砣	bll
濯	jzu
俎	wwu
糅	gqw
貅	ldw
饯	njt
溧	jqw
犴	lha
诓	epu
訇	reh
嗟	opy
莘	rfs
偈	dgr
乜	oln
靛	pux
郏	bcd
栾	zwl
葺	roy
锃	cou
螯	rva
泫	jax
褓	tow
懋	wwv
锉	cth
镫	cec
掾	kpl
媾	xnp
桠	wky
枰	whc
萋	rax
稔	viv
荻	rls
琚	usu
侩	dwi
蝮	vak
槁	wzo
遴	gnn
岫	isx
皖	klv
鹜	qkt
皈	kvi
菟	rxt
蓑	rte
邳	sjd
蔺	ryu
襁	txv
徉	hpy
盥	xpa
幂	lgz
觞	nbh
炅	gsg
貔	lcl
阡	dfq
呖	ovc
蚨	vbf
溉	joe
懔	nti
颧	rub
糨	gxv
虱	omv
蜮	vto
舢	pis
铩	ciw
鸷	ptz
砀	bhp
咭	ofj
腩	uzc
沆	jtp
氮	tss
忝	jmj
抟	kiq
薜	rsf
睢	qus
狴	llh
烩	swi
缃	arx
悌	ncx
蝾	vrw
抻	kgf
猢	luu
嘞	ozc
爻	iiy
牍	ial
嶷	iax
蒿	rzo
骅	ila
钹	cxb
嵇	vei
孑	bvj
俅	dpe
墒	hzb
愎	nak
囡	sxn
饽	nab
橐	aow
梏	wzo
轸	gwf
纂	fqj
韪	gxi
黢	cqk
羸	tpl
狍	lrd
撺	klf
仃	ddd
殚	nca
鬣	miz
樟	wia
桎	wfz
呙	oig
璺	xpu
璎	uqx
镏	cks
橹	wxg
祆	tjm
酵	qyb
徜	hbp
崂	irc
铀	csy
榔	wed
肓	tuh
镁	cpm
芩	riq
狲	lbj
铡	cqv
祉	txz
酪	qkl
酗	qif
擢	kzu
珐	uhq
鼬	xzs
啮	oxf
鹑	zbt
椿	wpg
镞	cua
镛	cmu
蜢	vba
檬	wrl
箔	fjk
饨	nrf
貊	lbg
馄	ngl
椋	wzj
寮	lmj
逦	jpn
蝌	vvl
骢	icv
蛔	vso
辂	gkl
诿	evx
伥	dxc
殓	nwb
挝	kon
诨	elg
爿	ivp
铨	cwu
珲	ulg
楸	wvs
赊	qwi
窳	lss
赁	dcq
谌	eql
聩	yvq
煲	dos
钨	ctw
茯	rdm
摺	kzk
罹	qnu
硭	brt
掼	kpq
蚋	vir
旮	qgg
铣	czr
絷	paj
辍	gii
酊	qdd
蛐	vgv
暨	oej
蜇	kev
镝	czu
肛	uyg
莠	rvh
砒	blp
邴	jid
栉	wrd
驺	inz
柠	wld
歃	fxy
鳕	xez
怼	iov
訾	xle
鲧	xmj
雒	kul
酩	qno
黩	cal
耆	ylg
嘬	ogi
孢	brd
誊	pet
斫	bez
媸	xtv
岬	isj
嵬	ikr
泖	jad
蹉	ypy
蟊	qvv
遒	cnq
缛	avo
轱	gug
旯	gql
褫	tvp
谯	eur
纛	pjj
僭	deg
妁	xre
孛	alb
诟	exo
闱	yid
谶	ett
虺	jrv
檑	wes
榈	wyo
跎	yll
牯	zug
煨	sse
悒	nog
祧	tcc
瑗	ubi
闫	yby
蚺	vph
獾	lru
揆	kem
诙	ehs
嫱	xas
囿	shu
箸	fyz
啖	oss
痂	mhj
廿	rjn
赭	hzy
蔗	rmr
鼹	xzx
篙	fzo
辔	aao
椤	wqn
阒	yqm
埠	hra
伉	dtp
嫫	xem
钴	cug
饴	nqo
荚	rbc
裾	tsu
弁	qrb
衢	hqe
阕	yej
痔	mho
葆	rdw
蟋	vmv
锴	clk
糸	ajm
喑	oiy
岿	ivz
豕	ljs
蚪	vld
笞	fqo
晗	gio
蟀	vta
菀	rld
隍	dku
逶	vxn
暝	gls
茕	rla
撷	kfb
拮	kfj
獭	lwq
磔	blw
滦	jzw
嘁	otn
荇	rhe
搽	krw
笮	fhz
胪	uns
滁	jdw
泅	jsw
湎	jbq
娩	xnr
觥	nbr
饬	nac
徕	hxc
闰	yur
掴	ksu
璜	uns
唁	oey
涝	jrc
汞	ypg
傈	dqw
錾	gec
巯	hyi
鲽	xfw
讫	eao
俚	dal
姘	xcp
猁	lvv
菅	rlr
耦	xsp
荟	rwi
谥	eca
绻	apd
肱	uhq
埙	hoq
铆	cad
琨	ugl
狎	lsx
哙	owi
耄	ylf
珉	udr
挈	ykk
逑	pen
炻	sbs
怄	npi
鳝	xpo
汛	joa
铂	ckb
跹	yfn
徭	hbz
埂	hji
颢	gjb
猞	lwu
铖	cto
蓐	rvo
楹	wha
貘	lem
凼	pfd
赅	qyg
稹	vas
镗	cbh
癣	mxp
铢	cxz
裱	tpe
倥	dly
涞	jxc
阆	yeo
傩	diu
钎	cfq
蜉	vbb
悱	nyf
仄	vwz
粕	gkp
纥	aao
焘	yor
珙	uns
栎	waj
胰	umx
脔	ziw
缳	aqe
觜	xlb
锝	cgo
蕤	rlm
唿	orv
柚	wsy
荜	rla
鲫	xod
洌	jnv
螈	vvj
秆	vhg
骞	lni
蕲	rae
仵	dzw
苻	rdo
斛	nbl
搴	lnk
瘙	miv
獍	lir
郗	ihd
醴	qgc
铬	ckg
篁	fku
杷	wgp
烊	spy
郜	zod
纩	amk
脍	uwi
鹂	jpt
牝	zlp
骈	icp
莳	rgo
熨	sos
钿	csd
冼	czr
柑	wrj
孀	xer
恚	avh
氦	tyh
湟	jku
锒	ceo
锌	cfx
鹬	qpt
戕	itq
缦	agi
虻	vtm
篾	fqt
衽	tcr
帏	zid
轾	gfz
碣	bgr
膂	umu
堞	hfw
暾	gzk
鼐	hii
炝	swd
窨	liy
鲟	xzo
偬	drv
硌	bkg
恽	nlg
咴	ohs
竦	fwo
邰	qod
虢	bop
覃	qga
韭	yjj
蕨	rvy
铉	cax
泵	bpb
帧	znq
胱	ubr
缟	azo
屐	shi
苌	rxc
腱	uzn
侔	dqz
鳃	xsv
讦	ehj
圻	heq
椽	wpl
癯	mqu
灏	jgb
洮	jcc
拊	kdo
眙	qqo
尜	jmj
骝	iks
髭	mxl
蝰	vma
痨	mrc
竽	fhy
狯	lwi
剡	ssv
鼋	vol
腚	ulx
猱	lqw
辚	ggl
螫	hkv
缢	aca
酶	qap
嘌	oqi
椴	wyr
洹	jjj
趺	ybf
盱	qhx
犍	zzn
镊	cyi
噻	olh
庹	mrm
钙	cjq
赡	qne
罅	zff
珥	uye
狃	lpn
镙	csj
撄	kqx
圩	hhx
杌	wjr
峄	iih
箴	ftj
炔	sdq
茔	rlh
墉	hmu
鏊	rca
焙	sfo
馏	nks
畲	wis
欹	mgy
洇	jsm
吡	olb
仟	dfq
馐	npp
宥	lhu
鼍	zsl
苫	rns
囹	sie
荛	rtr
氯	tzp
昃	gvw
缱	avn
峤	imv
龈	xfo
睇	qcx
娈	zxl
蹼	yke
榛	wpv
蟥	vns
臬	uwn
殳	rms
擀	kwh
旄	ufm
犰	lqq
彀	hxr
狁	lqr
诤	enk
傣	dpp
裢	tgn
搠	kcu
樨	wsz
鹌	mlt
踟	yao
铰	ctl
焖	syv
痢	mvv
锰	cba
厣	vms
瘐	mxw
蠹	avv
楫	woy
澧	jgc
郓	lgd
秸	vfj
砦	xlb
璁	ucv
柞	whz
纫	ake
纡	ahy
腭	uzq
骐	iqq
黟	cnn
瘿	mqx
捭	kxb
芨	rhj
笳	fhj
嵯	ipy
颏	ybk
郧	oqd
妣	xlb
钾	csj
酃	ezd
圄	svo
稞	vgw
苡	rjy
杼	wqd
戡	qlt
勐	bac
薨	rnl
蛉	vie
澍	jfo
雩	eiq
骘	dxi
憷	nwx
茴	rso
诜	ezr
淖	jna
筅	fzr
佚	day
襦	tea
郇	rgd
吖	ocf
檫	wli
帔	zop
垭	hky
凫	tpf
鹗	zqt
钯	cgb
邗	hdh
舛	nlc
謇	lne
荠	rzv
佤	dpw
矽	bnx
喁	osp
粑	ggb
垓	hyg
苕	rko
浔	jzo
芫	rvy
煸	sfa
蝓	vwu
迓	jdn
杓	wre
躅	yqr
褡	tro
矾	bpe
喈	olk
沔	jjo
樘	wbh
锨	cey
蜊	vvv
搦	kxx
鲵	xxr
烷	slv
蕈	rqa
刭	hyv
丨	ffs
幛	zia
踯	ycd
堠	hsa
闼	ymn
愀	nvs
鄯	pod
缁	ais
氰	tpu
瓤	tes
肜	ufr
摈	kle
氟	txv
厶	qvs
瀣	jij
鲰	xyi
怫	nxv
坩	hrj
陉	dhy
疟	mzy
褰	lne
渑	jol
笫	fqm
裣	twb
菸	ruc
痼	msu
阄	yng
缗	adg
媪	xga
疱	mrd
悭	nih
尻	sqk
罴	qhr
燹	lls
疥	mwv
衿	tij
艏	pcu
亳	zmr
邛	ydq
眭	qas
旒	uti
茏	rol
樯	was
艄	pbu
孳	cab
鲶	xiv
卅	cjs
黍	vwp
鲑	xag
氖	thn
怛	ngj
枋	wuf
蒹	rcz
菘	rwq
豌	jcd
泶	bpx
笏	frp
忉	nkd
淝	jug
榉	wbh
踽	ymp
廪	mti
裎	tou
桁	whe
萑	ruh
濂	jmz
鲈	xns
疹	mwf
逋	inb
栳	wyl
蚍	vlp
苒	rph
蝣	vub
铙	ctr
殍	nbb
陂	dob
埚	hoi
麂	flp
妊	xcr
唢	obq
锗	cyz
擘	sfk
趸	boy
赍	atq
谰	eyw
歙	wzy
縻	mwj
焯	sna
矬	ath
烯	siz
荩	rmc
艨	prl
眇	qjm
瓴	iep
亍	ejc
佧	dnc
叻	ocl
箝	fkr
勰	ccv
氨	tlx
喱	ova
飨	amn
翥	yzz
侪	dzv
桫	wjj
鲠	xji
茑	rtn
蚝	vfh
跗	ydo
焓	sio
洄	jso
疽	muj
笤	fko
篦	fcl
鹕	uut
雎	uuj
胺	ulx
蹰	yvo
阋	yxr
钬	csh
镪	cxv
馕	nae
艟	pfa
毂	hgr
鹈	cmt
庠	mpx
猗	lmg
瞽	faq
疴	mgk
踅	key
棼	wsk
睾	mqa
鹳	rut
疡	mhp
锍	cti
漭	jrr
跸	yla
醮	qur
砬	bfl
濉	jqu
柢	war
泷	jol
逄	kln
埘	hgo
陟	dxj
耋	ylf
笄	fpj
蚧	vwv
蝥	qkv
塄	hqu
萘	rmi
郯	ssd
烃	shy
酮	qpj
彖	plt
痫	myw
鼙	fax
掮	kfu
趿	yht
帑	xiz
馔	nds
鲇	xnn
畦	saq
蚜	vjd
枸	wro
狷	lou
尢	ejy
稗	vxb
窠	lgw
溘	jha
矸	bhg
岢	igk
沭	jwe
钲	cjx
蠃	tvl
睃	qqk
庾	mxw
扦	kfq
鸱	art
哚	opw
菔	rui
枥	wvc
轳	gns
蟛	vff
觋	ytl
祜	tuh
蚰	vsy
狳	lww
倬	dna
锱	cis
蛄	vug
醪	qzf
囟	cix
爰	bhi
奁	mpi
擤	kur
槎	wpy
鞒	zmv
嬗	xtj
嗉	opj
鳐	xbz
柘	wbz
毖	lvm
舸	pgg
镍	cuw
鋈	jmc
潆	jrj
侑	dhu
谘	eyo
耔	xbz
锕	cdg
豳	ill
芾	rjz
乩	nlj
渌	jzp
禳	tte
綦	qaj
锑	ccx
钤	ciq
砭	bmo
鳏	xqc
辊	ggl
娠	xve
鬻	xxp
洙	jxz
墀	hsz
孥	xib
疣	mee
茇	rxb
耪	xfu
芪	rar
愆	hev
筮	fyt
榫	wua
栀	wxd
薅	rxo
萁	rqq
蜞	vqq
蛩	ypv
罨	qml
鳟	xco
阍	yar
龃	xfu
莰	rhy
酽	qkm
栲	wyq
氪	tur
饣	nms
崤	iiu
啁	oph
铋	cvm
碘	bps
觚	nbs
毽	fzh
捌	kyv
樾	wxt
瘢	mpr
茌	rdh
鹚	cat
骶	qar
菏	ggh
糁	gqf
穑	vas
溏	jmo
刖	uvy
嫜	xia
螽	kvv
缒	arn
滹	jff
髋	qll
攮	kae
楂	wwj
戽	flh
铧	cla
囝	sbn
愍	dkv
坭	hsl
熵	szb
澶	jtj
鲂	xuf
鞯	zrb
橛	wvy
飧	nns
痈	mby
枞	wtz
殂	nuc
冱	cjp
匏	mqr
蠼	vqi
嵊	ivc
艉	psf
岙	mmi
樗	weq
遄	ibn
舂	pxc
椟	wal
尕	hjg
柙	wsx
伧	dwd
坻	har
瓠	mqs
镬	cri
髡	mfr
薮	rxk
蔌	rwy
龉	xfo
鹾	nsy
讣	enf
皲	lgo
髁	qgw
杲	gwg
芰	rai
椐	wsu
橼	wpl
缯	acg
鸹	ftg
龋	xfp
莪	rkt
锞	cgw
圹	hmk
黧	vrc
隈	dse
彘	pal
暌	gem
餍	vmn
赜	ppq
筚	fla
泔	jrj
嘏	usi
疠	mbo
鸬	nst
檠	rkw
饧	nhp
醯	qta
蚬	vlx
蓖	rcl
哏	oog
蹁	yfa
朐	uro
疋	vxs
甑	cgp
绂	axf
铗	cbc
髫	mfo
螅	vuv
宄	lqg
芎	rxx
摭	kmr
膣	ulf
苷	rrj
骟	ifz
圯	hdy
棹	wna
枳	wos
啭	oiq
蔟	rua
妫	xcc
鍪	qkc
夤	nlj
牖	ifi
觯	nba
棰	wfn
盍	hqa
茭	rtl
耨	xvo
鞣	zqw
钡	cqb
礅	bzk
苴	ruj
熘	sks
硼	buu
秫	vwe
铊	cll
柁	wll
壅	tah
飑	prd
膈	ujp
钪	ctp
箜	fly
缡	azp
醚	qgn
敉	gkm
甯	lvb
潍	jau
寤	lio
肄	lah
阈	yto
跏	yhj
栊	wol
栌	wns
涑	jwo
脘	ulv
酎	qoz
柒	jrw
谵	ene
鲳	xgg
茈	rxl
痱	myf
鬈	mfd
蛳	vjz
秭	vmq
阏	yuw
捩	kfm
镆	cem
枇	wlp
枵	woq
氚	tic
皴	qko
堀	hsi
讴	epi
圊	spu
穰	vte
蟮	vpo
忄	nex
笥	foo
焐	svo
菖	rgg
绐	aqo
儋	dne
邡	udf
蓼	rzf
蒌	rgx
圮	hdp
浠	jiz
廨	mnz
怙	nuh
闶	ytp
瓿	fop
诂	eug
粳	gji
鳓	xzc
漯	jsj
眚	mpq
庑	mhl
苎	rlj
觳	hbr
楗	wzn
徼	hkk
莨	reo
黥	czj
芴	rrp
酰	qzr
柽	wih
钭	clt
揿	kcy
蓊	rsz
馑	nrp
喾	bzo
僳	dqg
揎	klj
挹	kog
芏	rhd
剀	idv
愦	nvq
曩	gte
袢	typ
酾	qjp
硒	bqx
曛	gfc
俣	dom
笊	fsz
卮	xdz
汊	jie
郴	wdc
雠	ueu
鲷	xph
仂	dcl
莴	roi
癍	muu
榧	wpy
鹣	czt
蘖	rrw
旆	ujz
蕖	gpw
桡	wtr
荪	rbj
婺	qkx
妯	xsz
钣	cvi
亻	dmr
垆	hns
沤	jpi
屣	shx
卺	vpd
嫠	xvx
蘼	rmy
坶	hpm
蘧	rfn
镒	cca
蕞	ryi
玢	usk
厝	vng
锆	czo
鬲	jop
詈	qel
箧	fpb
铴	cjh
怃	nhl
浜	jes
鳔	xqi
缶	zmf
藿	reu
蛑	vqz
柰	win
鼗	cci
蓥	rlc
欤	syy
钚	csb
丌	rjj
蛞	vfk
娌	xal
鲆	xhc
癔	miv
鄣	iad
酢	qhc
骖	iqf
酲	qou
碓	bud
妗	xij
麈	flt
傧	dle
燔	sms
黻	kzx
缂	azk
鹩	mjt
碛	bpq
铱	cte
塬	hvj
韫	ida
揸	kwj
趵	yre
屙	sdg
猓	lgw
檩	wti
谝	efa
笸	fpo
蜣	vpl
溽	jvo
蜩	vph
乇	mrt
囗	sfw
痦	mvo
赀	xlq
萏	rnx
偾	daq
鄄	qhd
岘	ilx
揠	kpg
伛	dpi
碚	bfo
阊	ygg
蕺	ryt
孓	vke
镧	cyw
锊	cbo
铍	cop
溱	jpv
昝	kng
胙	uhz
瑷	ubi
邶	cld
坫	hnd
伲	dsl
芑	rdq
缬	afb
硎	bpv
镟	cux
糌	gng
隹	umc
坼	hee
幞	zke
戢	oyt
崃	ixc
髀	qxb
忭	ntn
箪	fca
瞢	rqq
筌	fwu
菽	rji
荨	rzo
郅	fdz
锛	cmr
笾	fcn
篪	fvp
辏	gpm
癜	msr
钒	cpe
哕	oin
敫	kuk
廑	mrp
鲢	xgn
仳	dlp
厍	vgs
砷	bgf
蓍	ryg
鳎	xgz
圬	hiq
欷	ihy
碹	blj
甏	ffp
檗	sfw
豉	jci
淦	jcg
磙	bte
苣	rps
艿	rhn
颞	yib
嗍	ocu
胝	uar
槠	wey
诼	ele
诹	eyi
麸	pkb
蛱	vbc
鞫	zre
锂	cal
荞	rmv
轫	gke
椹	wql
郾	pgd
楱	wpm
迨	qon
氘	tvd
槲	wnl
耩	xnp
熳	sgi
缌	asv
恂	nrg
铟	csm
卣	nss
唣	okr
苁	rtc
裉	tok
瘰	msj
泺	jaj
锘	cro
璩	ufl
薹	rfh
阌	ybi
堙	hqh
茺	rtr
砩	bxv
蓠	rzp
啉	owl
黾	ogl
诒	eqo
唑	oth
砗	bgc
羝	par
顸	hbh
刳	mqv
杩	wim
俳	dyp
慊	ncz
缫	aiw
茼	rpj
狺	ley
缍	afn
圪	hao
麇	flv
悝	nak
尥	ere
狨	lth
铯	cng
嗾	oua
胗	uwf
痤	mth
隳	dhj
镢	cvy
鹋	rst
槭	wtn
畹	sld
嵛	iwu
饫	nmm
蘩	raj
赓	mzq
绲	agl
翮	jpz
郐	wid
缧	asj
酹	qbo
唛	opk
颟	reb
蠓	vrl
眄	qjo
葚	rql
腧	uwu
溲	jxs
溻	jgz
踬	yvq
怍	nhz
畚	qms
嬖	sfx
糍	gca
旰	ghg
鞲	znp
涫	jlr
颃	tpb
荭	ray
嵴	icu
垲	hid
呒	ohl
胼	ucp
芡	ryq
朊	uvr
馓	nnk
跣	yzr
刈	ivy
萸	rxw
龠	wza
帻	zpq
瘳	mzf
疸	mgj
磴	bec
陔	dyg
醢	qha
踺	yzn
蠲	car
蛸	vbu
硖	bbc
鲞	pxx
蚴	vac
镲	cli
戥	gpt
葑	rao
篌	fda
栝	wfg
耧	xgx
峁	iad
堋	huu
芘	rlp
謦	hre
鸲	rot
颡	iwb
鄞	rpd
嗌	oca
踔	yna
疔	mdd
铒	cye
犭	lmq
桄	wbr
屦	shx
侉	dmq
粝	gvo
瘘	mgx
痧	mjj
绨	acx
葸	rsv
薏	riv
仉	dpz
廛	mah
簟	fqa
裰	tii
畈	svi
鲋	xdo
舻	pns
皤	kms
嗪	opv
凇	csq
谇	eta
掭	kjj
燠	scm
虿	bov
莼	rar
毳	fff
簦	fec
蹀	yfw
胍	usg
缣	acz
枧	wlj
鲮	xhk
陧	dgh
泮	jyp
梃	wcn
醑	qvu
勖	gqc
谖	ebi
谳	eme
铘	cjd
轭	gvd
酐	qhg
庋	mai
僬	dur
贶	qor
醅	qfo
蝤	vcq
垧	hco
锬	css
趑	xcy
菹	guz
龀	xfl
藁	rzw
诖	eag
匦	pgq
笕	flj
硷	bwb
锩	cpd
垅	hol
肭	uin
陴	dxp
吣	ovq
醛	qru
蒴	rtu
邾	xdz
鳊	xfa
鸸	bat
桴	wbb
搿	kwk
胲	uyh
剞	mgv
鬏	mvs
芤	rbl
嵝	igx
艋	pba
悛	nqk
疝	mis
柝	wee
鲔	xhu
拶	kin
黹	kcz
舯	pyz
箅	fsr
榇	wfw
菰	rbs
煳	suu
劂	vcv
蚵	vgh
礞	brl
钼	cqm
嬲	scc
劬	roc
肽	ume
洧	jhu
硪	bkt
葙	rrx
埸	hgr
廴	nvy
躜	yzq
鬯	ifl
匚	pjf
鲱	xyf
砜	bpf
呋	obf
莩	rbb
鹨	zft
墁	hgi
觫	nbw
辋	gpc
隰	dgr
獯	lfc
佾	dsu
媵	upx
趱	xzz
髌	qle
埕	hou
谠	ebr
碲	bfz
垤	hfd
唪	oph
绀	arj
铪	cwo
洚	jkl
嫘	xsj
楝	wwq
甍	rqp
髂	qlk
磲	bpw
绱	abp
潲	jbu
鲥	xgo
铵	clx
舨	pvi
羼	spp
笪	fgj
酚	qsk
刿	inv
曷	grl
溷	jsl
骱	qwv
胬	xii
俜	dsq
銎	ypc
诎	efi
枘	wir
镡	cqa
粜	fig
浯	jvo
绁	afx
崦	iml
劓	urv
蓣	rdb
菝	rkx
鐾	sfc
蛏	vih
汆	mep
甙	trj
蒽	rsv
绋	axv
岣	iro
崮	isu
岵	iuh
掎	kmg
挢	kmv
讵	eps
窭	lgx
赉	xcq
掊	kfo
芟	rrs
毹	wuf
锶	csv
慝	prv
氽	wpt
芄	rqe
怿	nih
鹆	sbt
瘵	mei
啶	olx
蔸	rkr
砘	brf
罟	qug
蚶	vrj
鲎	bxh
锾	cbi
湔	jcu
搛	kcz
柃	wie
逯	zpn
亓	ivq
屺	idq
郄	ihd
檎	wwp
毵	qff
渖	jlf
肟	uiq
饩	ntx
躞	ysi
谮	eeg
酯	qlg
塍	uph
擐	kqe
蠖	vri
觖	nbd
跬	yak
氇	fxg
嘧	oli
蝻	vzc
湓	jsa
氆	fck
庥	mdw
嵫	ica
撙	kco
褊	tfa
篼	fkr
鳜	xvy
劢	boc
蛴	vzv
汔	jao
骀	iqo
醣	qmo
腽	uga
舾	pqx
仡	dao
莸	rle
黼	kzi
袼	tkg
缑	asa
笱	fro
袷	two
肼	urj
僦	dee
蒉	rvq
阃	ysw
臁	umz
倮	dgw
芈	fjh
杪	wjm
蠛	vrt
蛲	vtr
凵	fvk
硗	btr
跫	ypy
荽	rbx
渫	jfw
崾	iqx
瘗	mbh
箦	fpq
舳	psz
阝	dvf
黪	cqf
锸	cfx
瓞	sad
滏	jlc
戆	ikv
遘	npn
簋	foa
鹪	urt
扃	fpo
篥	fqw
鞔	znr
浼	jnr
庀	mlp
肷	uyq
鲭	xpu
埽	hzz
钽	cgj
酴	qww
溆	jwi
钸	chz
髑	qqr
鳆	xak
黉	bns
逭	lrn
浍	jwi
裥	tyg
榘	apw
犋	zus
钌	cvk
躐	yiz
砻	obl
苤	rsj
榀	woz
钋	cnp
綮	fkj
氵	jes
胂	ugf
锼	cxs
炱	qos
疃	sfa
煺	son
鼯	xzo
籼	gix
芗	ram
儇	dqe
砟	bhz
肫	urf
秕	vlb
踣	yfo
刂	vfd
帱	zyo
氡	tkc
垌	hpj
佴	dye
糇	gsa
肀	zfy
澌	jqe
耜	xrs
龆	xfo
禊	tkm
溴	jum
氩	tky
吲	oxf
岜	igb
惝	nbp
蝽	vpg
腠	upm
徂	huc
硐	bpj
镉	cjp
虼	vao
烀	smf
蟪	vhv
桷	wnb
坜	hvc
瞵	qgl
簏	ffl
镘	cgi
擗	ksf
筇	fyd
扌	kjs
畋	skt
葶	rzd
沲	jak
穸	lnx
眢	ndq
搌	kse
埴	hau
陬	dyi
砹	bri
畀	srb
鹁	abt
觇	nlc
彳	hmc
瘅	mca
菪	rlb
铞	coz
锇	ckt
钫	cuf
廾	rjg
砉	ybh
锪	crv
哜	ozv
钅	cmj
锔	cso
膦	ugl
螨	vre
茆	rad
埤	hxb
铈	ctz
裼	tgr
迕	znw
氙	tix
楦	wlj
讠	eey
蛘	vpy
镱	civ
霪	ejc
畛	swf
碡	bpp
缵	azq
锿	cze
襞	sfe
髟	mfb
蒇	rtq
冁	cae
籴	meg
揲	kfw
镦	czk
苊	rvd
疳	mrj
茛	rog
鳇	xku
攉	keu
虮	vpj
镓	cll
噍	our
弪	xhy
胩	unc
罱	qzc
苈	rvc
蠊	vmz
埝	hiv
钕	cxn
羟	phy
羰	pis
轺	gko
舴	phz
潴	jly
萆	rxb
晡	gib
爨	xps
榱	wte
铥	cfq
鸫	tjt
胨	utj
罘	qsf
槔	wka
鹱	tri
墼	grh
骒	igw
悃	nsw
漤	jwx
稂	veo
诔	exl
鲡	xjp
疬	mvc
钔	cym
淠	jsr
裒	txe
缲	aow
薷	rea
埏	hmn
谂	eiv
鲦	xkw
莛	rcn
榍	wsu
髹	mdw
砑	bjd
垸	hlv
帙	zaz
窀	lrf
浞	jyz
辶	nec
褙	tlu
苄	rtn
骣	isb
舡	pyc
岽	itj
攵	kmp
赙	qio
漶	jov
跽	ydv
疖	mdj
腈	upu
桕	wxj
桊	pwj
埒	hbo
镅	csq
镎	cwk
哌	ove
郫	xdp
冖	lem
锖	cpu
畎	sme
悫	hlv
颥	eab
唼	ofx
钐	cfs
矧	axf
牾	zvo
鹇	ywt
殪	nhc
鳙	xmu
饔	tan
籀	fks
鄹	ypd
宀	lem
坌	skh
荸	rab
艚	png
艹	rja
觌	all
铫	ccc
鲼	xaq
澉	jvk
哿	hgg
瘊	mda
骺	qxo
豇	jcy
筘	fko
硇	bci
聍	yld
蜱	vxp
丿	mmp
氍	quf
酞	qme
钍	cht
沩	jcc
洫	jma
珧	ucc
舁	xry
瀹	jwa
粢	cyg
鲅	xxb
鞴	znb
窆	lmo
瘛	myv
镄	cxq
祓	txf
恝	ykv
瘕	msi
戋	jtj
鲒	xfj
醵	qfl
瘼	mem
铌	csl
脬	ubb
葜	rym
椠	gew
瞍	qxs
羧	pqk
冂	pfj
粞	gqx
蓰	rhx
窬	lwu
哳	oke
轵	gos
忮	nai
埯	hml
聱	rya
礤	bri
搋	kvp
憝	zkv
钆	clg
艽	rqj
鳘	akx
恧	bav
襻	twk
氕	tmp
镨	ccg
铷	cxo
洳	jxo
蟓	vxx
鸺	dwt
铕	chu
驵	iuz
迮	hnz
廒	mra
濞	jur
巛	ivc
嶝	iec
耵	ydd
蹯	yms
篚	fpy
嚆	orz
劐	riv
鲚	xzv
鲣	xih
趼	ypj
赆	qmc
爝	sbo
钶	cgk
鳢	xgc
荬	rvl
镤	cke
桤	wid
筲	fbu
堍	hxt
箨	fkh
蕹	rmu
钇	coy
罾	qcg
夂	kmz
橥	lyw
鲻	xis
阼	dhz
揞	kia
庳	mxb
馇	nwj
怊	nko
脞	uth
埭	hzp
塥	hjp
绠	aji
蕻	rqs
鲩	xlv
癀	mns
洎	juj
礓	bjj
捃	kzo
锎	cyp
轹	gaj
跞	yaj
瞀	qkq
猸	lsq
鹛	sqt
脒	ugm
耱	xmb
衄	map
甓	sfp
锓	czi
脎	uiw
滠	jyi
鲐	xqo
萜	rzn
砼	bwy
涠	jsi
衤	tey
甾	isz
痄	mhz
浈	jnq
瘃	mle
舭	plb
螬	vng
躔	ymh
枨	wxc
眵	qnn
镩	clf
卩	dvj
垡	dth
稃	vbb
郛	bbd
酤	qug
崞	izb
蜾	vgw
捍	kgh
谫	eck
纟	avs
眍	qpi
癃	mdp
毪	fqz
仫	dmq
垴	hzf
筢	fkg
锫	cfo
螵	vqi
岍	ipq
亠	tet
阢	djr
菥	rwe
鼷	xzm
薤	rnj
舣	pei
著	ryz
丬	cep
腙	uli
蒡	rfu
勹	rmb
鹎	xtb
滗	jff
缏	adi
醭	qke
猹	lwj
瘥	mpy
膪	ufo
阽	dnd
簖	fle
牿	zzo
馘	cut
撖	kvk
虍	ffh
缋	avq
牮	szj
铼	cxc
铹	crc
泐	jdc
墚	hkw
镥	cxg
苠	rdr
脲	usp
蒎	gve
犏	zfa
钷	cpo
劁	urv
鼽	urq
磉	biw
鲺	xom
礻	tes
贳	fqs
摅	kfv
耥	xbp
螗	vmo
箢	fnd
軎	gow
莶	rwb
痃	max
痖	mky
疰	mtz
碥	bfa
瘭	mqi
傺	dei
鼢	xzk
瀵	jgs
艴	xvg
戤	hat
筻	fji
觏	npl
鲴	xsu
轷	gmf
耠	xwo
灬	reh
茳	gyj
喹	oma
醌	qgl
蒗	geo
铑	cyl
耢	xrc
蔹	rbk
稆	voo
攴	nip
苘	rpo
赇	qpe
辁	gwu
彡	fms
赕	qss
铽	ctv
猃	lwb
糈	gvu
酏	qky
茚	rad
齄	urj
绗	ahe
荮	rao
夼	mik
螋	vxs
耖	xjc
蒈	rlk
鲕	xba
禚	tpr
鳋	xiv
冫	ceb
屮	tvc
彐	zvj
疒	men
啰	oqn
瞭	qmj
珅	ugf
