的	x
一	i
了	p
是	g
不	s
我	k
这	z
在	c
人	e
有	y
他	t
来	yc
个	ef
道	u
你	tn
大	j
到	r
着	h
就	d
上	n
们	tp
那	hd
也	w
说	ec
么	m
下	ei
出	o
然	ne
地	hw
中	kf
看	kq
时	gk
要	px
没	jr
天	ij
过	kn
可	xi
自	b
子	bp
能	q
还	sn
之	a
以	gp
去	hq
好	xb
后	go
为	cc
都	yd
会	ep
里	f
心	we
得	ig
对	zk
身	am
手	km
起	xd
小	jf
想	cw
只	os
而	bv
和	v
头	qe
她	xw
无	hl
力	cp
面	bd
己	dp
如	xo
现	al
什	ta
样	wh
多	nn
已	dpy
知	mo
些	xl
经	ay
声	hs
前	uu
神	zg
笑	dm
事	ao
开	qi
点	nr
方	ie
眼	qq
发	rp
所	vs
但	tg
气	vm
法	jh
意	yw
情	nh
两	fi
生	mh
家	l
间	pg
将	un
很	iq
真	au
话	ez
成	tu
让	en
被	zz
老	yl
动	pc
当	bpd
用	bm
于	hi
见	lf
回	oo
又	zp
军	lfj
把	kg
此	xlc
才	ki
几	pm
战	nt
正	ix
龙	zi
明	gu
从	wm
却	hqd
长	zm
十	ai
三	bi
女	xp
光	bir
再	ap
向	co
实	lq
最	gs
行	ib
高	do
本	wi
打	kk
定	li
进	rn
魔	mw
风	pmf
给	ae
问	po
国	oa
色	ng
同	pi
种	vk
走	xiz
其	qiq
年	mq
口	of
王	aiw
怎	tw
边	cn
次	ct
全	ea
白	xm
吧	og
儿	rm
感	ti
果	gw
听	oe
啊	od
体	twi
外	nnw
死	nl
飞	ac
分	st
主	fe
觉	bl
住	tf
少	jfs
比	lib
空	ly
因	oj
门	pe
等	dh
轻	fy
直	auz
第	dx
候	ts
脸	ue
相	ci
强	xoq
何	tx
张	xz
快	nu
做	tfk
重	zf
与	di
太	je
应	mb
刚	pz
接	kv
位	tv
便	tiz
量	gi
更	igz
难	zu
名	no
二	die
内	hf
连	fn
水	bf
西	pix
黑	zfh
马	hp
部	vo
入	me
作	tt
吗	oh
兵	es
师	vi
虽	oq
别	uv
击	ho
放	ik
完	lv
四	or
灵	ps
公	sq
并	cq
先	lr
处	knc
士	his
剑	eb
算	dq
东	fj
机	wp
微	fp
城	ht
火	se
变	iz
叫	on
清	jhu
带	vl
杀	zw
斯	qes
李	wb
队	de
云	piy
者	yi
望	fu
原	vx
竟	yr
像	tb
惊	nd
呢	osl
安	lx
山	if
星	gm
族	im
海	jm
月	um
加	vp
金	cm
目	qf
特	lh
跟	fq
场	hh
林	wil
由	sf
万	bu
美	hj
任	tc
使	tz
日	gf
立	ve
命	eo
思	sw
关	uj
百	bg
转	fd
理	af
常	bo
血	mv
乎	mc
受	bz
离	zo
该	ey
界	sev
远	vn
平	hc
阵	df
物	lra
冷	cg
数	fx
信	te
刻	yv
至	ri
突	lj
失	mm
怪	nz
随	dy
五	ji
反	vz
找	kt
似	tgs
许	el
般	ir
武	it
雷	ys
非	yf
奇	jx
通	qb
解	nb
绝	an
怕	nx
精	fh
修	tk
暗	gy
满	jrf
双	zzs
度	mr
且	uf
红	ayh
半	ye
世	ui
始	xq
倒	tr
拉	kvl
今	gmj
它	ll
落	yk
攻	ykg
学	bb
尔	nj
传	td
音	yey
指	kl
路	fk
越	xt
表	hv
石	bis
容	ln
紧	vzj
哥	xx
合	eoh
罗	dn
利	vv
冲	ck
步	xj
够	ro
影	gj
姐	xu
伤	tm
若	ry
亲	vw
功	ycg
整	wk
弟	cx
丝	aa
息	bw
吃	om
众	ew
花	rt
势	ic
早	ga
哈	oeo
帝	vmd
流	jfy
团	ok
青	hu
根	wq
极	whj
静	huk
形	qfx
即	qd
深	jl
周	ph
近	enj
千	zmq
消	jb
结	ak
制	lp
干	hig
帮	ydm
速	wo
楚	wpx
性	nm
备	ks
系	ma
言	ee
提	kgx
教	yb
皇	xa
令	ge
文	ze
雪	yp
谁	eu
终	akc
必	wmb
站	vnz
化	tl
哪	ohd
破	bzp
认	eer
忙	nf
往	ifw
玉	aey
级	ah
车	fic
底	my
总	cow
坐	whz
巨	ksj
男	sc
显	gz
克	fr
各	kmg
新	vwe
斗	qed
仙	tix
急	np
切	ttq
阳	dg
叶	oay
领	geb
收	nk
衣	fv
敢	psk
异	dr
围	odd
达	jn
象	bmx
件	tlj
错	cj
服	ud
慢	ngz
保	to
办	cs
活	jz
喜	ku
片	gmp
杨	wha
兴	bs
刀	tpd
摇	kb
准	cu
夜	ft
拿	eok
电	gl
交	fw
条	kw
朝	aau
华	tla
管	dl
断	fl
兽	cso
决	cuj
尽	gc
苦	rf
依	tfv
易	gr
八	sm
则	qv
露	yfk
语	ej
兰	udl
闪	pes
冰	cb
足	ff
记	ed
德	ia
响	oc
害	lyo
及	hm
球	ab
阿	dxa
计	eaj
顿	tob
爱	by
告	lo
夫	bif
七	tiq
嘴	ol
器	rj
圣	zh
南	du
留	yt
元	viy
敌	zkd
沉	jlp
请	eh
官	lz
威	tix
每	mem
况	cor
确	bn
答	deo
乱	zl
陈	dfj
宝	la
视	zls
护	kp
格	wkg
脑	uz
兄	orx
狂	gak
淡	js
识	eos
题	gx
停	tdk
司	uio
低	ty
雨	yiy
呼	oma
久	nej
未	yiw
孩	byh
卫	diw
脚	uh
除	dew
古	fig
亚	ziy
字	lb
骑	hjx
房	pif
代	dmd
伙	tsh
鬼	xr
员	oqy
缓	abz
复	mg
六	fs
黄	jss
装	uhv
居	sfj
凌	ch
呵	ox
米	fem
恐	ypw
单	cga
旁	vip
钱	cit
跑	frd
布	ym
或	toi
爷	wd
玩	av
报	kd
疑	lm
术	wes
睛	qh
隐	dnw
欢	zt
续	aaq
章	ya
差	hy
挥	klf
父	wmf
句	roj
待	ih
九	wmj
派	jv
持	kh
类	fjl
宇	lhy
丽	ip
蓝	rv
佛	txv
刘	zv
忽	ra
怀	ns
您	tnw
怒	xzw
掉	kna
招	kto
希	zy
送	ujn
背	cl
工	yig
甚	ql
烈	nv
卡	nek
细	as
掌	bok
论	eel
密	lw
运	pn
退	qn
酒	jp
求	be
猛	gb
另	ufl
射	aks
集	uw
首	ub
北	clb
照	gt
晚	gn
赶	xh
守	lk
木	wim
散	ju
穿	lik
联	su
铁	cmt
段	yrd
练	afj
喝	ogr
需	ybv
支	az
巴	gpb
左	yy
陆	dho
角	nbj
书	pd
防	dif
忍	tew
莫	si
群	pmh
民	dt
客	lkk
线	ait
毫	dfh
肯	xuk
展	sj
谢	eak
亮	dpl
痛	mqb
股	ur
造	lon
妖	xmj
虎	pp
秦	hvq
紫	xlj
宫	loo
激	jxk
赵	xzz
渐	jfe
震	yvv
注	jfz
禁	wu
吸	ohx
取	sz
梦	wn
枪	wed
程	voa
叹	oz
江	jy
简	dpg
羽	cpy
友	yz
继	afl
念	gwn
右	yo
萧	rpj
热	irr
份	tst
乐	yj
压	vh
既	qij
靠	loy
香	vg
恶	zwe
引	xf
止	xfz
包	rd
追	zn
仅	tzj
寒	ljc
雅	iku
争	npk
愿	vxw
超	xto
狠	gq
厉	vb
式	tys
波	jzb
刺	wpv
号	oqh
态	jew
存	cbc
游	jib
台	qo
跳	fc
狼	geq
属	smp
妹	xy
炼	sfj
灭	is
英	ru
醒	pgh
举	bsh
嘿	ozh
境	hyr
胜	umh
诉	eee
抱	kr
毕	lab
务	kc
甲	sfj
齐	zvq
拍	kx
唐	mp
君	pmo
楼	wf
险	deb
院	dlv
建	phn
观	zlg
柔	qk
逃	ccn
置	da
娘	xe
担	kgi
殿	sjr
阴	duy
呆	ow
层	sp
试	et
约	ar
凡	pef
眉	sqm
弹	xc
救	bek
银	cqy
统	afr
否	so
索	alj
抓	kxz
府	mt
调	eph
曾	cgg
魂	pxr
基	qhj
顶	kbd
峰	iky
苏	rc
图	okc
松	ws
议	eez
料	fql
顾	vd
严	zmy
业	zfy
恩	ojw
礼	zll
耳	sie
选	lrn
余	ewy
败	qkb
区	kz
顺	ybs
皮	zpp
沙	jj
瞬	qbq
树	wz
秘	vwm
商	dns
组	auz
块	huk
汉	jzh
充	frc
贵	qqg
迷	fnm
混	jg
纷	ast
示	uis
伸	tgf
娜	xhd
助	uc
呀	oi
封	akf
排	ky
期	qu
肉	he
船	ipo
座	mwh
义	ezy
舰	il
闻	psw
升	mrs
室	lrs
妈	xhm
亡	few
付	tkf
控	kly
警	rk
负	nq
推	kut
扬	kha
模	wsm
芒	rfm
凤	pzf
虚	pzx
默	zj
土	hit
技	ka
费	xv
温	jgv
市	fm
麻	mwm
初	ztc
考	yq
拥	kby
究	lwj
握	ksr
资	ctq
普	uzg
翻	ms
察	lxu
独	gqd
幸	hua
舞	mn
称	vnj
玄	aex
母	epm
暴	gjb
按	klx
孙	bj
睡	qz
改	dk
换	knj
素	ha
较	ffw
具	us
箭	duu
品	orp
忘	fww
状	uje
堂	boh
副	nvf
承	pb
野	fqk
锋	cky
洞	jpi
遇	spn
查	wg
洛	jk
局	suo
赛	ljq
划	tvh
权	wzq
藏	rtb
味	oy
丹	pf
故	fkg
钟	ckz
坏	hsh
仍	th
宗	lu
弱	xcx
弄	arn
脱	ucr
菲	ryf
胸	urz
哼	odk
药	rar
历	vc
徐	iew
拳	hk
爆	sg
杰	wr
谈	ess
须	fb
坚	vzh
奥	cf
仿	tif
据	ksf
偷	teu
施	iw
产	vmc
营	rl
骨	nfg
晶	gg
透	vhn
尊	uk
短	mi
抬	kqo
政	ixk
烦	sb
河	jxh
牙	iky
维	auw
证	eix
卷	hdj
幽	iaa
草	rg
森	ww
吴	oij
摆	kdq
蒙	rlg
危	nvd
毒	hed
投	krt
熟	dw
飘	pu
导	dkd
朋	uup
质	va
释	mf
喊	ot
胡	fuh
参	qj
休	twx
劲	yyc
景	gd
挡	kbp
印	ydy
惜	njg
枫	wpf
幻	auh
欲	snt
摸	ksm
烟	soj
致	rkz
州	yez
冥	lg
尼	sl
抗	kfp
妙	xjm
翼	css
秋	vsq
凝	cqx
寻	pk
盘	iv
永	eby
板	wv
智	mog
哦	okt
责	hqz
尸	sps
傲	tpa
柳	wy
御	imd
临	vdg
浪	jeq
辈	yfb
娇	xmv
恨	nqh
吓	oex
价	tev
硬	biz
探	klw
际	duj
横	wj
标	wub
纳	ahn
欧	kzt
宁	lkn
墙	hao
田	sft
习	up
肩	puj
戏	ztx
奈	jun
设	er
效	fwk
福	znf
袋	dfv
移	vnn
型	qvh
疯	mpf
毛	fmm
贝	qfb
冒	gqm
叔	njz
碎	bfa
轰	fz
扑	knp
奋	jsf
饭	nvz
科	vq
惨	nqf
咱	ob
治	jq
湖	jfu
环	ash
尘	jhc
略	sk
躲	apw
免	nor
盟	guv
珠	ayz
迎	ydn
凭	tcp
规	blg
犹	gie
雄	yqu
距	fks
伯	txb
借	tj
域	hto
床	mwc
骂	rh
莉	rvv
朱	ymz
史	ozs
避	sv
聚	szb
皱	npz
秀	vhx
韩	aad
挑	kcc
降	dkq
敬	rok
源	jvj
徒	ixt
束	wos
鲜	bh
撞	kvf
岁	in
架	vwj
嘛	omw
哭	rje
袭	zfv
惑	tow
罪	dyz
节	rdj
罢	dhq
食	nms
啦	okv
唯	ou
买	pq
训	eyx
腿	uq
稍	vbu
校	wfw
艾	rz
诺	ero
某	riw
邪	ikd
鲁	bgl
姑	xfg
阻	duz
丁	kid
塔	hr
闭	pkb
迅	aan
逸	bny
臣	kfs
残	ni
裂	nvv
托	kmt
良	eq
泪	jql
尖	jjj
晓	gtr
伊	tpm
洋	jhy
屋	sr
尚	bpo
颗	gwb
鱼	bmy
炸	stz
仇	twc
讲	erj
焰	snx
配	pdp
旧	fg
绿	apb
假	tsz
圆	ooq
验	heb
番	mfs
搞	kdo
迹	fin
荡	yh
彩	bwf
腾	uhh
恢	ny
腰	upx
厅	vkt
牛	lmn
吼	obl
占	nfz
颤	fib
趣	xs
梅	wme
奔	ja
臂	svu
愣	ndi
勇	qbc
套	jt
剩	vcv
志	hwz
舒	efk
端	viv
虑	pw
医	kmy
妮	xsl
炮	srd
蛋	pxq
卖	apq
闹	pfm
颜	vmb
归	vpg
圈	ohd
限	dqx
浮	jbb
弃	frq
适	zns
软	ftr
抵	kyt
厚	vgb
帅	vms
尤	iey
讶	eik
广	meg
范	ydf
桌	ngw
欣	etx
病	mih
共	jsg
职	sos
诸	eyz
镇	ca
专	dqz
值	tau
偏	tpv
杂	wwz
增	hcg
豪	dgh
咬	ofw
触	nbq
陷	dnx
雾	ykc
挺	kcn
炎	ss
稳	vnw
择	kzh
巧	yqq
胖	uy
附	dtk
盯	qkd
碰	buz
纪	ad
阶	dev
谷	sng
嗯	oow
岛	eid
夏	bq
扫	kps
潜	jbg
毁	xyr
项	ybx
旋	ipx
抢	ke
抽	ksc
优	tie
迪	snd
涌	jqb
网	pzz
祖	zuz
拜	kiy
测	jqv
伟	tdd
案	lxw
列	nvl
谓	esu
操	ko
春	hg
店	mnd
瑞	aiv
善	huo
逼	nnb
浑	jlf
输	feu
烧	str
瞪	qx
慕	sjm
懂	nrf
富	lnf
汗	jhh
侧	tq
赤	hic
率	fa
杯	wsb
京	dj
吉	kij
滚	jfv
曼	gdz
浩	jlo
获	rgj
轮	fel
损	koq
抖	kqd
累	sa
讨	ek
苍	re
悄	nbu
养	hev
塞	ljh
鸣	oem
挂	kag
胆	ug
孤	bx
傻	tck
陪	dv
镜	cy
凶	zox
吐	oht
杜	whd
猜	gh
庞	mz
幕	smm
琳	aw
蛇	qll
拼	kcq
孔	blk
盖	hvg
材	wkc
扎	klz
爸	wgb
预	qkb
晃	gbr
闷	pwm
姓	xmh
莱	ryc
仔	tbz
吟	ogy
遍	pv
彻	itt
纯	at
伦	tel
盗	ctv
愤	na
困	owk
缘	aeg
纵	awz
啸	op
夺	jkd
壁	svh
宋	lws
估	tfg
介	ev
画	iso
庄	mhz
狗	gro
沈	jml
贼	qt
补	znb
摩	mwk
脉	ueb
泰	hb
痕	mqh
燕	ror
折	kez
劫	hqc
演	jli
灰	ysh
伏	tje
悠	tkw
婆	jzx
创	edv
研	bqy
含	goh
写	ld
凯	id
岳	eiy
午	lmw
池	jw
睁	qnk
萨	rdm
暂	feg
闲	pwx
概	wqi
逐	gnz
旦	gid
登	xiu
误	eoj
戒	trj
村	wkc
街	iab
跃	fmj
牌	gxp
廷	cnt
罩	dna
斩	fez
班	ava
爵	bqk
陛	dlh
膀	uvi
迟	gnc
踪	flu
替	bbg
谋	erw
伴	tyb
霸	yzu
傅	tak
怜	nge
乌	em
曲	gv
瞧	qur
惧	nus
俊	tqk
歌	xxt
咒	rpz
漂	jpu
嘻	oko
倍	tvo
采	bwc
昨	gtz
互	ieh
鹰	mte
蒂	rvm
舍	efs
慌	nry
糊	ffu
犯	gdf
扭	ken
判	yvp
丢	ziq
羞	hex
昏	ytg
竹	dmz
唤	onj
忧	nie
锐	ccr
琴	aap
宽	lrl
莲	rfn
躯	akz
郎	eqd
疼	mk
席	mrm
伍	tjw
剧	sfv
碧	ax
征	ii
鸟	emn
赞	llq
丈	ziz
侍	thk
悉	mfw
漫	jgz
缩	alg
帐	mzz
遭	jgn
坦	hgi
喃	odu
悟	njo
壮	uhz
辰	vvc
貌	gxr
鼻	bsr
聊	sy
怨	ndw
弓	xpg
绕	atr
私	vqs
耀	br
财	qkc
掩	kj
吞	ijo
织	aos
监	vdv
洗	jlr
佩	tpi
融	ipq
插	kzx
梁	jtw
忠	kwz
悲	ywb
笔	dfb
迫	xn
凉	cd
丫	cfy
鼓	kuz
豫	qkb
亦	fiy
敏	mek
狱	gje
召	toz
佣	tby
忆	nay
朵	pwd
博	aak
狐	gxh
吹	otc
拔	krb
荣	rlw
劳	rlc
茶	rew
缠	amf
盛	tuv
磨	mwb
浓	jmv
净	cnk
仰	tyd
遥	bln
废	mrf
恭	jsj
菜	rb
阁	pkg
缺	luq
粗	fuc
躺	abp
宣	lii
桑	zzw
绍	ato
惯	neq
遗	qqn
晕	glf
执	iiz
喷	oaq
刹	zwv
努	xzc
脆	und
轩	fhx
佳	taj
耗	yfh
窗	lc
积	vos
策	dwp
辉	brf
灯	skd
辛	vex
援	kbz
堆	hud
扶	kbf
踏	fbg
库	mfk
屁	slp
唇	vvo
奴	xzn
翔	hcx
熊	qlr
粉	fst
勒	zc
尾	sfw
批	klp
乖	zcl
艳	yn
趁	xef
慧	yyw
姬	xk
爬	xg
隆	dkh
怖	nym
赏	boq
晨	gvv
刃	ter
媚	xsq
耐	bvk
拖	kmw
丰	yif
码	bhm
诚	etu
律	iph
乃	hpn
赫	hii
曹	jgc
岂	idq
固	ofg
洁	jkj
盾	vaq
社	zhs
郭	db
骗	hpv
滑	jnh
霄	ybu
隔	dip
纸	ayt
戴	ats
额	lkb
惹	ryw
撤	kfk
荒	rfy
季	vbj
延	mx
痴	mmo
锁	cbq
旗	iqq
撒	kjk
郁	yu
典	pj
颇	zb
侯	tsm
园	ov
振	kvv
仪	tez
省	jqs
猎	gjg
殊	nys
绪	ayx
跪	fnd
玛	ahm
抚	khl
油	jsy
委	vxw
纹	azw
泉	xbq
滴	jd
洪	jjs
启	poq
供	tjs
忌	dwj
拦	kud
祭	xuj
妻	apx
贴	qnt
妇	xpf
庆	mj
擦	klu
币	mmb
婚	xyg
牢	lll
仁	tdr
甘	rig
奶	xhn
径	iy
倾	tlb
符	dtk
赌	qy
钻	cnz
蛮	iqm
矮	mvx
唉	oqm
堡	toh
馆	nlz
宜	luy
姿	ctx
爽	jzz
堪	hql
焦	urj
劈	svt
零	yg
薄	yak
扰	kie
艘	ixs
耶	sd
牧	lkm
益	usv
朗	equ
挣	knk
递	cxn
匆	rae
肖	bux
婷	xdk
亏	dqk
袍	zr
燃	ser
扯	kxc
叛	yvz
胁	ucs
拒	kks
肚	uhd
皆	lxj
柱	wfz
墨	zhm
董	rzf
砸	bk
莎	yjs
液	jfk
辆	ffl
途	ewn
岩	iby
芳	rif
慰	skw
户	peh
烂	sud
欺	qtq
针	caz
砍	bt
筑	dyp
醉	pfa
扔	khr
洲	jyz
协	acs
驾	vhj
享	dbx
漠	jsm
巫	yww
莹	rla
撑	kbk
郑	ujd
眨	qm
赢	fqy
恼	nzo
珍	aef
虫	qfc
康	mpb
椅	wjx
俩	tfl
旅	imv
货	tlq
减	cti
尝	bpc
盈	hz
愧	nxr
邦	ydb
骇	hyh
餐	nzn
埋	hfm
瑟	awm
抛	kwc
吻	ora
敲	dnz
猫	grs
侵	tpz
弯	ixw
茫	yfm
悔	nme
喘	oiv
穴	le
玲	ag
勾	rq
哎	orz
截	atu
舌	zms
肃	pjs
牵	jll
例	tnv
庭	mcn
彼	izb
宙	ls
氏	yts
夹	bc
霜	ycs
仗	tzz
济	jzv
吕	ool
渊	jvf
卓	nga
甜	zri
笼	dz
柄	wih
嘉	kuv
诡	end
姆	xem
脖	ua
爹	wnn
霍	yuh
抹	kym
艺	ray
倩	thu
秒	vj
昂	gyd
踢	fgr
哀	dva
末	yim
奉	hhf
劝	zcq
腹	umk
钢	cpz
宏	lyq
爪	xmz
挤	kzv
泽	jzh
鸿	jye
核	wyh
侠	tbc
猪	gyz
疾	mmj
瓶	cqh
僵	tii
乘	vcl
寂	ljz
粮	feq
聪	scw
诱	evh
懒	nw
搭	kro
潮	jau
鹏	uue
魏	vxr
咐	otk
鸡	zej
肤	ubf
薇	rfp
弥	xnj
瓦	hiw
央	ufy
勉	nrc
川	ymc
屈	soi
耸	wss
匹	krp
尺	gpc
喂	osv
丧	auv
悍	ngh
悬	uqw
拾	keo
晴	ghu
亿	tay
讯	eaa
溜	jts
魄	xxr
帕	mxp
括	kzk
孟	bvm
乔	mjv
怔	nix
蕾	rys
搜	kxs
诗	ehk
偶	tsp
均	hrc
童	vf
覆	pik
厌	vje
悦	nc
载	atf
掠	kdj
垂	zjc
琪	aq
泄	jux
霞	yfz
港	jjd
袁	hov
臭	bjc
衡	inb
构	wrq
肌	upj
词	eui
纤	azx
票	pup
诀	euj
饰	nmm
噬	ody
宠	lzc
脏	umh
袖	zs
键	cpn
穷	lcq
泥	jsl
驻	hfz
眸	qql
航	ifp
辞	zvc
乡	amx
催	tiu
宿	lt
慎	nas
魅	xry
撕	kqe
逆	cv
凑	chj
缝	akn
歉	uit
授	kbz
甩	ul
映	guy
岸	ivh
凰	pxa
唱	ogg
奸	xhj
陵	dhk
崇	ilu
枚	wkm
读	eaq
暖	gbz
扩	kmk
狮	gim
瑶	abl
沿	jpo
渡	jmz
稀	vzm
搂	kfx
恋	iwl
捏	kgh
饶	ntr
吩	ost
笨	dwi
返	vzn
赖	woq
斥	eec
贤	vzq
煞	nkr
询	erg
斜	ewq
撼	ktw
眯	qfm
铺	cap
咳	oyk
浅	jit
尬	iev
尴	ivd
齿	xeo
洒	jps
督	nzq
奖	unj
卑	xmb
染	jww
促	tfc
弗	xvf
娅	xzy
麽	mwq
泛	jma
契	ytj
酷	pl
罚	dev
络	akl
埃	hqm
课	eg
屠	syt
祸	zoh
汇	jkh
疗	mpk
赐	qg
刑	qvx
夸	jdq
雕	phu
检	web
祥	zhx
俗	tsn
俱	tus
摔	kfa
屏	scq
麦	hkm
闯	phc
予	qky
矿	bmk
恒	nii
郡	pmd
呜	oew
疲	mzp
迈	bun
寸	kic
详	ehx
亭	dkt
巡	ynx
滋	jua
葛	rr
婴	qqx
录	pbl
涛	jyk
冠	lvk
枝	wa
翅	azc
窜	lkc
昆	glk
婉	xld
妃	xdf
矛	qkm
蝶	quw
瘦	mxs
编	apv
俏	tbu
贪	gqt
繁	mkj
绵	axm
棋	wqq
斧	wef
裹	fgv
姜	hx
氛	vst
後	iak
乾	aaa
拨	krb
慈	uaw
瞒	qr
嫣	xiq
咕	ofg
屑	sbu
铃	cge
辱	vvk
雀	juq
冯	chf
允	qry
樱	wqx
愈	euw
宾	leb
晰	gwe
掏	krl
措	kjg
啪	okx
誓	kee
农	mvn
糟	fjg
驶	hoz
捉	kfz
祝	zor
朕	uuj
咯	okk
扮	kst
淫	jbc
鼠	xcs
畏	svw
羊	hey
驱	hkz
恰	neo
璃	azp
芙	rbf
烁	syj
岚	ipl
梯	wc
裁	atv
韵	yrc
咽	ooj
辕	fhv
夕	nmx
涯	jva
卢	nsl
碍	bgk
幅	mnf
扇	pcs
愕	nrq
芸	rpy
哇	oaw
润	jpa
崩	iu
县	uqx
杖	wzz
汤	jha
翠	cfa
健	tpn
箱	dc
恍	nbr
骷	nfk
捕	kab
育	fuy
猴	gsm
遮	mrn
泡	jrd
麟	pfq
扣	kok
鼎	qgg
溃	jqq
娃	xaw
髅	nfx
逍	bun
述	wen
豹	gre
评	ehc
献	due
涂	jew
序	mqk
铜	cpi
饮	nty
灾	lsz
湿	jgz
冬	kcd
贫	stq
汹	jzo
党	bor
棒	whh
贯	eqg
串	koc
丛	wic
昌	ggc
棍	wgl
嫁	xlg
弘	xqh
肥	ugf
穆	vxf
挖	kla
阔	pjz
跌	fmd
丑	epc
赚	qui
披	kzp
漆	jwb
奏	hij
贺	vqh
喉	osm
酸	pqk
捷	kix
卧	kfn
凄	cax
割	lov
违	dd
役	iry
坛	hpt
砰	bhc
筋	duc
裸	zgw
井	rij
涨	jxz
沐	jwm
仓	edc
巍	ixr
宴	lgx
饿	nkt
鞭	ztz
馨	hrg
瓜	xmg
骚	hzq
匪	kyf
耻	sx
妄	fxw
肆	tph
宛	lnd
裤	zmf
蠢	hqq
龟	ngl
妥	bxt
霆	ycn
雯	yzw
吵	ojc
驰	hwc
嫩	xwk
审	lgf
戈	tig
款	hut
桥	wmv
诧	elt
晌	gco
勃	abc
搬	kir
仆	tnp
漏	jsy
械	wt
彭	kuf
盔	ysv
灌	jru
桃	wcc
黛	dzd
黎	vr
饱	nrd
欠	tmq
抑	kyd
疆	xhi
嘶	oqe
辣	vwo
纠	anj
签	deb
购	qrq
镖	cpu
揉	kqw
愚	spw
勤	rhc
誉	bse
鄙	ood
衫	zfs
珊	ays
弩	xzx
呈	oac
腕	uld
怡	nqo
坠	deh
腥	ugh
培	hvo
牲	lmh
窝	loh
障	dya
锦	cxm
蓉	rln
拢	kzl
瞳	qvf
麒	plq
析	wex
脾	ux
涩	jtx
蓦	sh
铠	cid
嘲	oau
毅	vgr
僧	tcg
尉	suk
寺	hks
链	cfn
邀	xkn
企	ex
蜜	lwq
骤	hzb
趴	fsp
频	xjb
挨	kqm
蒋	ruk
卿	yqd
植	wau
刷	smv
厂	vic
歪	six
嚣	rbr
琼	adj
耍	bvx
龄	xoe
拟	kgn
崖	iva
寨	ljw
伐	ttf
丘	emq
柯	wx
磊	bbb
晋	zgj
艰	zq
竞	vor
碗	bld
慨	nqi
涉	jxj
艇	icn
谨	erh
荷	rtx
跨	fjq
浴	jsn
舱	ied
颠	asb
趟	xbp
盒	eov
撇	kck
骄	hmv
逊	bjn
坑	hfp
柜	wks
摧	kiu
崔	iuc
幼	acy
愁	vsw
仑	ell
姨	xjx
踩	fbw
谅	edj
坤	hgf
绑	ayd
锤	cz
哑	ozy
贾	pqj
宰	lvz
乳	bbl
陌	dbg
惠	hgw
竖	vzv
销	cbu
叮	okd
访	eif
虹	qyh
绽	alx
沾	jnz
添	jij
沃	jmj
挽	knr
迦	vnj
舟	imz
堵	hyd
鹿	pll
纱	aj
巾	mfj
荆	rqv
薛	rzv
绩	ahq
捂	kjo
枯	wfk
腐	mth
兔	bmt
凛	cfu
夷	jxy
梵	wpe
哗	ola
绳	aol
靖	vhu
搏	kak
斌	zit
颈	yyb
筹	dyk
逝	ken
厨	vik
辅	faf
逗	io
藤	rub
盼	qs
咦	ojx
尹	pmy
呃	ovd
芬	rs
狸	gfl
矩	mks
憾	ntw
膝	uwb
雁	vt
胳	ukg
咧	onv
沌	jto
於	iec
墓	shm
畅	gfh
擅	kfi
冻	cfj
摊	kzu
黯	zya
泣	jvq
楞	wdi
叉	zec
籍	dyg
牺	lpx
敖	pia
哄	ojs
铭	cno
霉	yme
躬	axg
淋	jwl
膊	uak
嫌	xui
歇	glt
捧	khh
痒	mhy
塌	hgc
嚷	ofv
涵	jpo
旨	lgz
灿	sic
摄	ksz
削	buv
茵	roj
嘟	oyd
匕	lmb
膛	ubh
拱	kjs
肢	uaz
眠	qdt
珑	azl
伪	tcc
斤	emj
逛	gan
惶	nxa
励	vbc
儒	tyv
陡	dxd
仲	tkz
瞄	qrs
哨	obu
羡	hct
掀	ket
辽	pkn
沟	jrq
墅	fqh
汽	jvq
档	wbp
隶	pbl
描	krs
俘	tbb
蜂	qky
呐	ohn
哲	keo
卒	fwa
赔	qvo
裙	zpo
哮	oyb
寿	yks
攀	wwk
杆	whg
旺	gaw
寇	lvn
吾	jo
篮	dvv
狄	gsd
储	tey
鉴	vdc
嘀	odf
虏	pcl
嚎	odg
赋	qit
隙	djj
炉	spl
呻	ogf
殷	vpr
污	jdq
辩	vev
篇	dpv
嗓	ozw
吊	omd
播	kms
颊	bcb
偿	tbp
冤	lby
耿	ssg
俯	tmk
俄	tkt
躁	fo
狞	glk
嗔	oas
廖	mcf
罕	lhh
狡	gfw
溅	jqt
蹲	fuk
焕	snj
缕	afx
嘎	obt
烤	syq
渴	jgr
篷	dkn
乏	maf
擒	kep
棠	bow
粒	fvl
祺	zqq
惩	iiw
患	oow
谦	eui
汪	jaw
押	ksy
辨	vvv
蛛	qyz
歹	nid
蕴	rav
沸	jxv
遣	qzn
陶	drl
迁	znq
版	gvz
咆	ord
彷	iip
囊	aov
劣	jc
芝	raz
潇	jrj
鳞	bfq
甫	aif
逢	kyn
玫	akm
狈	gqb
邓	zd
侦	tnq
炽	sos
竭	vgr
讽	epf
挠	ktr
拓	kbt
戮	cft
订	ekd
苟	rro
娶	szx
蔡	rx
丸	wew
佐	tyy
宅	lmt
厢	vcx
驳	hzz
拐	kug
昭	gto
弦	xax
淑	jnz
叠	zzu
俞	euy
辜	fvg
兼	upi
吱	oaz
腻	ut
础	boi
兮	sqx
琉	afy
蓬	rkn
厮	vqe
坡	hzp
咪	ofm
朴	wnp
妍	xqy
胎	uqo
刮	zvg
苗	rsm
廊	med
遵	ukn
蜀	drq
倭	tvx
浸	jpz
滞	jvm
梭	wqk
湾	jix
韦	ddw
玻	azb
禀	fou
茹	rxo
敛	ebk
澜	jpw
聂	szz
疏	pxy
瞎	qlo
豆	iou
溢	juv
犬	jeq
廉	mu
潘	jms
嗦	oaj
祈	zeq
灼	sre
瞥	ckq
斑	aza
顽	vbw
兹	uaa
糕	fhr
昊	gij
锅	coh
缚	aak
妞	xen
匠	kej
魁	xrq
鹤	lue
绯	ayf
谎	ery
榜	wvi
碌	bpb
拂	kxv
壶	hlz
昧	gym
遁	van
蔽	rmk
庙	msm
蹄	fvm
茜	rpx
腔	uly
堕	dyh
耽	sml
硕	bbs
壳	hlp
彪	ppf
肠	uha
钰	cae
岭	ige
嗡	osc
栋	wfj
葬	rnr
冉	phr
挪	khd
鞋	za
蹦	fiu
柴	xlw
蔓	rgz
陀	dll
姊	xmq
啧	ohq
妨	xif
窃	ltt
阎	pnx
盆	stv
焚	wsf
矢	mms
携	kuh
钉	ckd
帘	lml
俺	tjl
嗤	ovq
萝	rdn
沧	jed
循	ivq
搅	kbl
渺	jqj
兀	irw
狭	gbc
戟	aat
申	gfs
翘	trc
嘱	osp
拆	kee
津	jph
贱	qit
汝	jxr
暇	gsz
愉	neu
侄	trz
棵	wgw
谭	epa
轨	fwg
蚁	qez
啥	oef
媒	xrw
噗	oze
锻	cyr
赴	xnf
诈	etz
巢	ygw
捡	keb
哟	oar
衷	fkv
吁	ohy
彦	vmf
渗	jqf
峡	ibc
涡	joh
禅	zca
氓	fdt
浆	unb
租	vu
阅	pco
掐	knx
帽	mgq
揭	kgr
妒	xpd
毙	lnl
寞	lsm
孝	ybx
乙	apy
贸	ytq
革	zig
喔	osr
憋	ckw
蓄	ras
坎	htk
舅	xsc
絮	xoj
烛	sqz
歆	ytx
胞	urd
翰	aac
颖	lvb
彤	pff
唔	ojo
垃	hvl
圾	hhj
尧	tir
旭	wgx
寄	ljx
喀	olk
遂	ugn
阱	drj
泊	jxb
妾	vxq
瑰	axr
虐	ppn
潭	jpa
祀	zds
逻	dnn
璇	aix
税	vcr
嫂	xxs
填	has
蛟	qfw
怯	nhq
滔	jbx
弧	xxh
惫	ksw
煌	sxa
雍	fmu
衍	ijb
笛	ds
庸	mpu
兆	ccz
咚	okc
暮	sgm
卜	nfb
裳	bov
沫	jym
蝎	qgr
寡	lbt
蚀	nqs
枉	waw
粹	ffa
澡	jow
昔	jgx
摘	kdf
瀚	jec
寝	luz
熙	kdr
舜	bnq
售	uo
栽	atw
胧	uzl
贞	nqz
诅	euz
滩	jzu
韧	ddt
倚	tjx
睹	qyd
栈	wit
蝠	qnf
桶	wqb
卦	ang
臀	sru
狰	gnk
姚	xcc
雇	pug
署	dys
狙	guj
泼	jrp
诛	eyz
朦	urg
栏	wud
筒	dpi
哧	ohi
溪	jbj
册	ymc
窥	lbl
湘	jcx
犀	sbl
舔	zij
剥	pbv
磁	bua
惕	ngr
旷	gmk
佑	tyo
歼	nzj
兜	ysr
窟	lsi
枕	wml
囚	oeq
裴	yfv
胀	uzz
楠	wdu
觑	pzl
擂	kys
拽	kgl
捣	kei
蕊	rw
巷	jsd
乞	maq
谱	eug
蚩	viq
哩	ofl
琢	age
垒	qqh
胃	suw
虞	poj
绣	avh
衰	fov
扁	pvb
菩	rvo
颅	nsb
骆	hkl
抄	kjc
菁	rhu
纽	aen
贡	yqg
噢	ocj
桓	wii
绮	ajx
戚	tni
惟	nuw
慑	nsz
罡	dix
喧	oli
衙	ijb
瑜	aeu
岗	ipz
侃	toy
祷	zyk
萍	yhc
剂	zvv
莽	rjr
诞	emn
轴	fsz
嘘	opz
烫	jhs
咙	ozl
鞘	zbu
丞	pbi
剿	ywv
孽	rzb
淘	jrl
翎	gec
翁	sqc
恕	xow
衬	zkc
倦	thd
揽	kdl
疚	mne
轿	fmv
秃	vpt
猾	gnh
钦	ctq
嗜	oyg
掷	kcd
藉	ryg
鸦	ike
陨	doq
熬	pr
窍	lyq
郝	hid
芷	rxz
咖	ovk
勋	oqc
铸	cyk
叨	otd
乍	tmz
磕	bhv
扳	kvz
霎	yvx
姥	xyl
棺	wl
奢	jys
辟	sov
叙	ewz
畜	asx
嫉	xmm
蜘	qmo
搁	kpk
钥	cuy
陋	dil
茅	rqk
倏	tkj
瘫	mzu
菊	rrf
匙	gxl
翩	pvc
倘	tbp
擎	rkk
趋	xnp
窄	ltz
峻	iqk
啡	oyf
嗽	owt
醋	pjg
酥	pvs
伺	tui
恳	qw
粘	fnn
哆	onn
绞	afw
绷	auu
丐	inq
渠	jkw
娱	xoj
佘	eus
淌	jbp
履	sik
塑	uuh
症	mix
衔	icb
蔑	rdt
禽	ezp
傀	txr
蛊	qvg
炀	sha
捞	krc
蒸	rpr
缄	ati
嗖	oxs
炫	sax
眩	qa
歧	xaz
邱	edq
挟	kbc
帆	mpe
莺	rle
渔	jby
敞	bpk
绰	ana
淳	jdb
厥	vct
瞟	qp
霹	ysv
疤	mgb
柏	wxb
徽	faj
讪	eis
猿	ghv
沮	juj
眶	qka
页	biy
卸	mxd
宵	lbu
惭	nfe
菱	rhk
踹	fiv
肿	ukz
萱	rli
斐	yzf
钩	cr
瓷	cth
雳	yvc
茂	rtm
肺	uim
届	ssj
鹫	dee
碑	bxb
儡	tss
蝉	qc
夭	mjy
娟	xou
曰	gfy
淮	juh
拘	kro
搓	khy
捅	kqb
豁	lon
亨	dpk
荐	rcb
漩	jix
捆	kow
沼	jto
迭	mnd
侮	tme
叱	olc
槐	wxr
迸	cqn
扛	kyk
屡	sfx
鲍	brd
脊	ccu
忖	nkc
婢	xxb
栗	pwl
驼	hll
贩	qvz
芦	rpl
拎	kge
彬	wfb
姗	xys
淹	jjl
怠	qow
钧	crc
嗅	obj
樊	wwj
弛	xwc
霓	yx
揍	khj
喽	ofx
汁	jaz
惮	nca
邻	ged
蟒	qrr
衅	mvy
瘾	md
账	qzz
览	vdl
妩	xhl
厦	vbk
妆	uxz
芊	rzq
抿	kdt
喻	oeu
吏	zol
澈	jfk
砖	bdq
僻	tsv
倪	txr
挫	kwh
杏	wox
襄	frv
桐	wpi
矣	qmy
噩	arr
揪	kvs
拧	klk
燥	sow
郊	fwd
喇	owv
沦	jel
蚂	qhm
阮	dvr
帖	mnt
戬	zgt
铲	cvm
孕	hby
跺	fpw
巅	isb
敦	dbk
婪	wxl
蹈	fbx
蹭	fcg
株	wyz
凹	ofa
婿	xpu
嬉	xko
盐	hn
冀	cls
膜	usm
剪	uut
鞠	zrf
桂	wag
盏	itv
襟	zwu
逞	oan
棘	wpw
焉	iqr
跋	frb
呕	okz
稚	vuz
嵌	irt
熠	scx
颓	vpb
妓	xaz
穹	lxq
邵	tod
涣	jnj
债	thq
梧	wjo
勿	raw
墟	hpz
焱	sss
桩	wmh
脯	uaf
镶	cfv
拭	kty
忿	stw
撩	kjj
涟	jfn
谍	euw
拇	kem
瑾	arh
疫	mry
掘	ksi
梨	vvw
窒	lrz
朽	wqx
奕	fij
涅	jgh
顷	lbq
咋	otz
酬	py
琦	ajx
蝙	qpv
吭	ofp
僚	tjj
镰	cmi
砚	bly
瞅	qvs
饥	npj
邸	ytd
漾	jhb
婕	xix
胤	rau
呸	osi
译	ezh
峙	ihk
寥	lcf
凸	oft
垫	ihd
肋	ucl
噜	obg
漓	jzp
剔	gav
猩	ggh
梳	wfy
峨	ikt
熄	sbw
睿	nlq
禹	mqp
址	hxz
蝴	qfu
萌	rgu
瞻	qne
眷	hqj
蹬	fxu
绘	aep
龚	zjs
岔	sti
唬	opp
飙	jjp
驭	hzy
漪	jjx
侥	ttr
肘	ukz
侣	too
熏	zzx
螺	qsj
聘	ssq
唾	ozj
幢	mvf
揣	kiv
坊	hif
湛	jql
谊	elu
箫	dpj
沛	jim
垮	hjq
妲	xgi
鹃	oue
翡	ycf
琐	abq
髓	nyn
讥	epj
裕	zsn
薪	rve
毯	fss
骸	nyh
癸	xij
苹	rhc
匿	kry
脂	ulg
玑	apj
澎	jkf
枢	wkz
懈	ntl
宪	llr
搀	knc
皓	xlo
悸	nvb
嗷	opa
跄	fed
镯	cdr
膨	ukf
憨	pkw
瓣	vxv
泻	jlq
踉	feq
黝	zac
葫	rfu
渣	jwi
麾	mwf
酿	peq
詹	nve
沁	jwq
眈	qml
畔	syp
懊	ncj
熔	sln
筷	dnu
霖	ywl
综	alu
傍	tvi
瑕	asz
刁	uid
嚓	olu
惚	nrw
践	fit
兢	frr
尿	sbn
秉	vpb
伞	eca
崆	ily
棉	wxm
媳	xbw
坟	hzf
鹅	kte
瀑	jgb
鲸	bdj
逮	pbn
糖	fmo
缉	aos
稻	vbx
暧	gbz
奎	jak
绸	aph
隋	dyu
狩	glk
湃	jiy
叽	opj
饼	ncq
靡	mwy
锥	cuz
碟	buw
拙	koi
簇	dim
蝇	qol
蚕	ijq
叩	odk
咸	tio
亢	fpk
澄	jxu
骏	hqk
辖	flo
媛	xbz
姻	xoj
扒	ksb
赠	qcg
秩	vmz
朔	cvu
倔	tsi
嚼	obk
卵	ycd
胶	ufw
绚	arg
镔	cle
蚊	qzw
唧	oqd
炯	spo
罐	lru
浊	jqz
冶	cqo
讳	edd
杭	wfp
弊	ckr
戳	cut
禄	zpb
斋	zbv
搐	kas
炙	nsz
佬	tyl
聋	zsl
厄	vde
凳	xip
鲨	jjb
驴	hpl
盲	fqm
锢	cof
锡	cgr
诏	eto
伽	tvj
铮	cnk
缭	ajj
鸭	sey
捶	kzj
唰	osv
搔	kzq
滥	jdv
恙	hwy
谜	efn
啃	oxu
啼	ovm
驯	hyx
匣	ksx
悯	npz
鸾	iel
杉	wfs
煜	sgv
拣	kfj
拯	kpi
偎	tsv
呛	oed
绅	agf
屿	idy
煮	yrz
璐	afk
冈	pzg
甄	phh
匈	rzo
钓	cre
咔	one
笙	dmh
桀	nqw
蜥	qwe
囔	oav
缴	axk
喳	owi
泳	jeb
睬	qbw
祟	oiu
崎	ijx
谣	ebl
晖	glf
炭	iys
忑	ewt
栖	wpq
娴	xpw
忐	niw
榕	wln
堤	hgx
哽	oiz
烬	sgc
炒	sjc
棱	whk
肝	uhg
靴	ztl
痞	mso
阀	pt
缪	acf
赦	hik
殖	nau
纲	apz
璧	sva
厘	vfl
泓	jxq
涕	jcx
壤	hfv
懿	huw
闺	pa
浇	jtr
匀	rcy
棚	wuu
娲	xoh
蔚	rsk
稽	veg
虾	qex
劭	toc
茨	rct
戾	pje
橙	wxu
厕	vqv
捐	kou
瘟	mgv
舵	ill
芯	rwx
晒	gps
烙	skl
驸	htk
亵	fvi
颂	sqb
钝	cto
窘	lmo
懦	nyv
稷	vsk
赎	qaq
袅	efv
庶	mrr
腮	usw
绢	aou
葱	rrw
溶	jln
榻	wgc
吨	oto
貂	gto
哉	ato
娥	xkt
悚	nwo
虔	pzq
蹙	tnf
婶	xlf
屎	sfs
磋	bhy
殆	nqo
诩	ecx
蠕	qyv
偌	tro
拚	kqr
骼	nkg
觅	blm
旱	ghh
裔	fvp
昱	gvy
冕	gnr
屯	tot
惋	nld
萎	rvx
苑	rnd
枭	ewx
惺	ngh
砂	bjs
殴	kzr
叭	osb
梢	wbu
缨	aqx
蹿	flf
飓	pus
峭	ibu
甸	rsd
谐	elx
澳	jcj
聆	sge
腊	ujg
缜	aas
帜	mos
昼	ggi
滕	uhb
茧	rqj
绫	ahk
汰	jje
皙	wex
踱	fmz
嵩	ido
兑	cor
诊	eef
葡	rra
筝	dnk
邃	lun
辑	fos
獠	gjj
昕	gex
蜡	qjg
奄	jgl
诵	eqb
腑	umk
悻	nha
憎	ncg
嗨	ome
敷	aik
庇	ml
榴	wts
晦	gme
祢	znj
荀	rrg
慷	nmb
寓	lsp
茉	rym
咄	ooi
曙	gdy
噪	orw
吒	omt
缸	lyg
幡	mms
啤	oxp
烨	sla
忡	nkc
粥	xfx
悴	nfa
咏	oeb
颔	gob
洽	jeo
募	scm
驿	hzh
藩	yms
靶	zgb
谬	ecf
憔	nur
邹	npd
痹	msr
绊	ayb
酋	ueq
框	wka
茄	rvq
挚	ikz
萄	rrl
恬	nzt
聿	phy
檀	wfi
凿	zuo
璋	aya
钞	cjc
褐	zgr
蟹	ntq
鬟	tfv
铛	cbp
曦	ght
崽	isw
胯	ujq
璀	aiu
菇	rxf
眺	qcc
瘩	mro
璨	azf
抡	kel
斟	qlq
褪	zqn
涎	jmn
勺	res
溟	jls
疙	mma
坪	hhc
猥	gsv
塘	hmo
揖	kos
逾	eun
冽	cnv
遏	grn
芽	rik
裘	bev
徊	ioo
函	pbo
槽	wjg
蟾	qne
睫	qix
珂	axk
嘭	okf
蒲	yap
煎	uur
庚	mpe
荫	rdu
稿	vdo
徘	iyp
蛙	qaw
睽	qxj
廓	mdd
滨	jle
彰	yaf
锵	cnk
掺	kqf
缰	aii
芭	rgb
嗒	oro
嘈	ojg
暄	gli
琅	aeq
萤	rlq
旬	rgx
翱	xac
栅	wyz
缈	aqj
猝	gfa
魇	vjr
攒	klq
蜴	qgr
鞑	zjn
窿	ldh
扈	pog
蜷	qhd
秽	vin
崛	isi
谕	eeu
袱	zje
瑚	afu
磅	bvi
缔	avm
攸	tfk
缥	apu
惬	nkb
撅	kvt
钮	ce
阙	pcv
鸽	eoe
葵	rxj
曳	glm
蔼	rer
礁	bur
苛	rxk
佗	tll
庐	mpl
珀	axp
稠	vph
娉	xsq
嗣	ovu
饵	nse
耕	yrg
肴	zyu
渎	jaq
嵋	isq
伶	tge
瑭	amo
懵	nrq
饷	nco
韬	ddx
恃	nhk
浦	jap
邢	qdx
咻	otw
隧	dun
贷	dqd
滢	jra
掳	kpc
颁	stb
芜	rhl
檐	wne
祯	znq
吝	zol
蘑	rmb
咫	gos
茬	rch
怦	nhc
缀	azz
扼	kvd
唠	orc
趾	fxz
殃	nuy
噼	osv
掂	kmn
啐	ofa
羌	hlq
畴	syk
枷	wvj
捺	kju
禾	vmh
绒	aty
邮	sdy
辙	ffk
籁	dwq
煽	spc
戎	tyr
糙	fln
漱	jwt
竿	dhg
瘪	mbl
矫	mmv
汀	jkt
吆	oay
怅	nzc
攘	kfv
叼	oui
昵	gsl
烽	sky
猖	ggg
芥	rev
紊	zaj
甬	qby
跷	ftr
靓	hul
栩	wcx
簌	dwt
寐	lgy
壕	hdg
侈	tnn
嫡	xdf
黏	vbn
亩	fsm
酣	pri
舆	xfs
痊	mea
娆	xtr
侏	tyz
佯	thy
锣	cdn
佼	tfw
羲	hqt
棣	wpb
鳄	brq
惘	npu
霏	yyf
媲	xcl
蔷	rao
篝	djp
蛤	qeo
虬	qlq
荧	rls
舷	iax
螂	qed
溺	jxx
羿	cry
巳	dps
仕	ths
攥	kdj
桦	wla
氧	vhy
殇	nmh
捻	kgw
胄	suz
臧	tlb
萦	rlj
漉	jpl
骋	hsq
券	htq
贬	qma
瑛	aru
迂	hny
晟	gtu
雏	npu
勘	qlc
煤	srw
坞	hew
衮	fsv
蓓	rto
蹂	fqw
蜒	qmn
忒	twt
晏	glx
牡	lhm
札	wlz
缎	ayr
膏	dou
屹	ima
肮	ufp
哒	ojn
煦	grr
棕	wlu
糜	mwf
瞠	qbh
筱	dtk
躏	frp
臻	rhv
淤	jec
瀛	jfx
蹊	fbj
孰	dbw
沪	jph
浙	jke
毗	slp
呱	oxg
磐	irb
矜	qkg
幺	apy
俨	tzm
琥	app
胴	upi
暑	gys
雌	xlu
锯	csf
硝	bbu
酱	unp
喋	ouw
箍	dkk
婧	xhu
玺	nja
羁	dzh
骁	htr
拈	knn
迢	ton
衲	zhn
呗	oqb
钵	cwi
鬓	tfs
剖	vov
蜿	qld
鞍	zlx
伫	tli
恤	nmv
铿	czh
鸳	nde
蝗	qxa
茸	rsr
赃	qmh
谴	eqn
邑	ogy
俐	tvv
吮	oqr
刊	hvk
钳	cri
亥	yeh
噎	ohu
巩	ype
驹	hro
薰	rzz
踌	fyk
饕	opn
矗	auu
躇	fry
蹑	fsz
弑	zwt
崭	ife
褚	zyc
湮	jph
踞	fsf
恺	nid
鸠	wej
邯	rid
渍	jhq
汴	jfn
蜈	qoj
惦	nmn
谑	epp
砌	btt
辎	fys
贿	qyu
癫	mab
诫	etr
赘	pqz
伎	taz
铐	cyq
诣	elg
匡	kak
岌	ihj
旎	isl
锈	cvh
桅	wnd
鸯	uey
鲲	bgl
莞	rlv
玮	add
剌	wov
茱	ryz
祁	zdq
奠	ujd
岱	did
辫	vav
闵	pzm
燎	sjj
椒	wnz
缇	agx
惴	niv
疮	med
酌	pre
窖	llo
邬	edw
呦	oac
顼	abx
岐	iaz
捋	kbk
飕	pxs
楮	wyc
帷	muw
笃	dhd
噔	oxu
骰	nrt
鄂	rqd
珏	aae
汩	jgg
鑫	ccc
嘤	oqx
掰	ksk
峦	iil
冢	lge
瓮	sqh
唏	ozm
蟆	qsm
掣	lvk
隘	duv
瞩	qsp
茗	rno
哝	omv
拷	kyq
蚣	qsq
慵	nmu
洼	jaw
牟	qlm
娄	fxl
敝	cmk
孜	bkz
龌	xoh
餮	nen
窦	laq
烘	sjs
咣	obr
飒	vps
咎	kno
憧	nvf
逵	hsn
闽	pqm
啷	oed
睨	qxr
铅	cpo
楷	wlx
绎	azh
皎	xfw
龊	xof
阉	pjg
黠	zkx
隼	uas
菌	rov
钗	cze
诶	eqm
杠	wyg
靥	vjd
饲	nui
蜃	vvq
筛	dvm
淼	bbb
粪	fjs
颍	lbb
喏	oro
苔	rqo
啬	auo
闸	psz
憬	ngj
伢	tik
酝	ppy
柬	wdj
啄	oge
窑	lly
旖	ijx
喵	ors
寰	ldv
羔	hrg
膳	uho
缅	abd
垣	hii
筠	dhr
乒	emp
榨	wlt
笈	dhj
瞑	qls
剁	pwv
奚	ba
兖	fsr
庵	mjl
瓒	alq
孺	byv
梓	wvz
杵	wlc
扉	pyf
诲	eme
坍	hpf
咂	okm
噤	owu
峥	ink
纶	ael
壑	nzh
殉	nrg
辐	fnf
蜕	qcr
唆	oqk
阖	phq
谛	evm
穗	vhw
琶	aag
螳	qbh
盎	uva
褒	ftv
贲	arq
毋	epw
淬	jfa
藻	yjw
粟	pfs
袜	zyw
佟	tkc
簸	dqz
苇	rdd
醇	pdb
枣	wpc
拗	kac
椎	wuz
橡	wbx
蹋	fgc
遐	ssn
拌	kyb
馋	nnc
橘	wqp
霭	yer
啜	ozz
撮	kgz
馒	ngz
纬	add
嬴	fxy
潺	jsb
筏	dtt
宦	lkf
娑	jjx
鹭	fke
玎	akd
抉	kuj
匍	rap
蕃	rms
恻	nqv
乓	eep
苞	rrd
胥	pxu
帛	xmb
驮	hjt
痪	mnj
碾	bsv
陕	dbc
嬷	xmq
髯	tfh
嫦	xbm
耷	jsd
阑	pwd
迳	yyn
弈	fir
眦	qxl
侬	tmv
娓	xsf
噘	ovt
炬	sks
沥	jvc
曜	gcu
禧	zko
陇	dzl
咛	olk
砾	byj
竺	ddz
胭	uoj
涧	jpg
墩	hdk
呲	oxl
篡	dqq
昙	gpt
蟠	qms
旌	imh
睦	qhh
羹	hrj
琵	aal
咀	ouj
馅	nnx
讷	ehn
磷	bfq
孵	ybb
濒	jxb
亘	igi
簧	djs
诬	eyw
擞	kfk
魃	xrr
瓯	kzh
曝	ggb
删	yvs
徨	ixa
宓	lwm
桨	unw
楣	wsq
铎	czh
剐	ohv
匐	rnf
腆	ups
谏	ewd
粼	fny
阐	pcg
婀	xdx
邺	zdy
纨	awe
辗	fsv
卉	arh
偃	tkg
鹊	jge
槛	wdv
荼	rew
锭	clx
瘴	mya
瑙	ayc
皂	xtz
踝	fgw
铳	cfr
锄	cuc
剃	cmv
吠	oje
蛰	iqz
琰	ass
叟	xms
缤	ale
颌	eob
珈	avj
浏	jzv
卤	noz
匾	kpv
飚	pss
刨	rdv
杞	wdq
馁	nbx
瘸	mvh
榭	wak
绛	akq
姒	xgs
殒	noq
瓢	pux
窈	lac
栓	wea
婊	xhv
譬	sve
谄	enx
垠	hqy
壹	hlu
呤	oge
烹	dpr
靳	zej
丕	sip
蕉	rur
隅	dsp
礴	byk
嫖	xpu
炊	stc
珞	akl
挲	jjk
蛾	qkt
膺	mtu
猬	gsu
潞	jfk
筐	dka
骜	pha
俑	tqb
鳌	pba
稣	bvs
蒜	ruu
窕	lcc
腋	ufk
魑	xrz
芮	rhr
簪	dig
麴	wkr
黔	zgq
垢	hgo
屉	sut
馀	new
笋	dpm
轼	fty
汲	jhj
迥	pon
垄	zhl
弼	xbx
沣	jyf
稼	vlg
纣	akz
郢	oad
藐	rgr
寅	lis
戍	tes
簿	djk
拄	kfz
泌	jwm
渲	jli
嚏	oax
呓	ora
篆	deg
斓	zpw
鲤	bfl
熹	kur
圭	aig
锏	cpg
螃	qvi
茎	ryy
龇	xol
丙	ihb
皑	xid
睚	qva
撂	ksk
惆	nph
鸥	kze
嚅	oyv
炳	sih
谧	ewv
篱	dzp
跚	fys
渤	jac
螓	qhv
矶	bpj
梗	wiz
岑	igc
槌	wzn
糗	fbj
滤	jpw
蛆	quq
拴	kea
晁	gcc
犷	gmg
潼	jvf
灶	shz
踵	fzf
坝	hqb
髻	tfk
嗲	own
袒	zgi
晔	gla
碳	bis
麓	wpl
渝	jeu
涔	jip
卯	ydm
菡	rpo
泯	jdt
撬	kff
羚	hge
抠	kkz
嗬	orx
馈	nqq
骠	hpu
凋	cph
赂	qkl
噌	ocg
鸨	lae
苜	rqm
幌	mgr
褥	zvk
嘹	ojj
袂	zum
荤	rlf
囤	oto
裆	zbp
盅	kvz
醺	pzz
萃	rfa
赧	hiz
婵	xca
氤	voj
腼	ubd
梆	wyd
涸	jof
釜	whu
镭	cys
椭	wyu
祠	zui
硫	bfy
晤	gjo
隗	dxr
痉	myy
笺	dit
饺	nfw
睐	qyc
峒	ipi
涤	jkw
俸	thh
玟	azw
谪	edf
渥	jsr
劾	ych
氲	vgv
挛	ikl
蹒	frf
霈	yjm
舫	iif
鳅	bvs
苋	rlx
琬	ald
怏	nuy
嗫	osz
瞰	qpk
蚌	qyb
溯	juu
沓	bgt
翌	cvy
蜻	qhu
甭	sbb
唷	ofu
藕	ryp
疵	mxl
啾	ovs
绔	ajq
毓	mey
桉	wlx
癖	msv
蝼	qfx
韶	yto
霁	yzv
蔬	rxy
跤	ffw
甥	mhc
颐	kfb
怂	wws
炕	sfp
咿	opm
咤	olt
毡	fnz
桔	wkj
鳖	ckb
弋	tiy
撰	kds
晾	gdj
泞	jlk
嗝	oip
霾	ygf
蟑	qya
臌	uaz
掬	krf
绾	alz
獒	pje
璞	aze
臊	uow
臾	xey
恸	npc
贮	qli
阂	pyh
岖	ikz
翟	cud
咨	cto
堑	feh
倡	tgg
忏	nzc
妤	xqk
啵	ojz
殛	npi
瞌	qhv
哐	oka
圃	oap
蛹	qqb
俭	teb
灸	nes
剽	puv
缆	adl
橱	wvk
秤	vhc
搪	kmo
嗥	oxa
粲	nzf
钛	cje
圳	hyz
邕	yog
畿	ats
鹦	qxe
淀	jlx
褂	zan
瘤	mys
忤	nlw
笠	dvl
挎	kjq
渭	jsu
糯	fyv
祗	zyt
肾	vzu
恿	qbw
垛	hpw
鹉	ixe
纺	aif
觎	eul
觊	idl
潋	jek
猊	gxr
豺	gkc
胚	usi
魍	xrp
琛	alw
炜	sdd
揶	ksd
鬃	tfu
汜	jds
辘	fpl
雹	yrd
玷	and
撵	kbf
颦	xbx
坳	hac
杳	wgy
荃	rea
揄	keu
摁	kow
咝	oai
辄	fsl
箩	ddn
鹞	ble
犸	ghm
捎	kbu
潦	jjj
蚯	qeq
翊	vcy
湄	jsq
芋	rhy
靼	zgi
濑	jwq
郸	cad
啕	orl
粱	jtf
镀	cmz
汐	jnx
榆	weu
淇	jqq
魉	xrf
脓	umv
苯	rwi
赈	qvv
觐	rhl
坷	hxk
篑	dqq
哂	ops
旃	ipf
齑	zyv
荦	rll
裟	jjv
辇	bbf
幔	mgz
蘅	rib
颚	rqb
犄	ljx
惰	nyu
徙	ixx
蚓	qxf
柿	wfm
睥	qxp
讹	etl
嵘	irw
嗵	oqn
暹	gun
悼	nna
罔	puf
琏	afn
蠡	eqq
囵	oel
骊	hip
堰	hkg
趄	xuj
宸	lvv
垦	qhk
啻	vmo
趔	xnv
魈	xrb
麝	plk
摒	ksq
遢	gcn
癌	moi
漳	jya
瑁	agq
硅	bag
斡	aaq
锚	crs
玳	add
耙	ygb
沽	jfg
颉	kbj
湍	jiv
袤	fqv
卞	fnb
纰	alp
壬	cmr
褶	zcx
袄	zmj
肇	pkh
犁	vvl
鼾	brh
邋	yon
忻	nex
淅	jwe
侨	tmv
诽	eyf
孪	ibl
倨	tsf
脐	uzv
皿	vfm
阗	pau
嘣	oiu
螭	qzp
腴	uxe
骡	hsj
恣	ctw
瘠	mcu
噶	orr
掸	kca
谙	eya
愠	ngv
谲	eqp
叵	kop
痰	mss
薯	rdy
袈	vfv
淄	jys
彗	yyp
恪	nkk
孱	sbb
迄	man
蔫	rqr
蜗	qoh
癞	mwq
遑	xan
噫	oyy
羯	hgr
鲛	bfw
涓	jou
罂	qql
褛	zfx
揩	klx
嫔	xle
褴	zdv
郦	ipd
潢	jjs
镑	cvi
馥	vgk
炖	sto
镣	cjj
瘁	mfa
桧	wep
讧	eyh
迩	njn
涮	jsv
澹	jne
嶙	ifq
徵	faz
蔻	rlv
豚	ugt
镂	cfx
轲	fxk
篓	dfx
禺	spi
樵	wur
遽	pgn
怵	nwe
孬	sxb
臃	ufu
芹	req
挞	kjn
偕	tlx
酆	yud
臼	xmj
贽	iqz
碉	bph
蒯	ruv
夙	pns
煊	sli
蓁	rhv
掖	kfk
帚	plm
泠	jge
臆	uyw
粤	cfq
銮	icl
抒	kqk
偻	tfx
庖	mrd
椰	wsd
琮	alu
匮	kqq
峋	irg
榄	wdl
盹	qto
轧	flz
诋	eyt
夥	gwn
憩	zbw
戛	bqt
瞿	qqu
佻	tcc
遨	pna
阜	zaf
镳	cpr
蜓	qcn
鏖	plc
摞	ksj
忪	nsq
噙	oep
夔	umk
仞	tte
荑	rjx
鸢	tey
洱	jse
姣	xfw
腺	uxb
泱	juy
捱	kva
跆	fqo
闾	poo
犒	ldo
琊	aid
盂	hvy
骥	hls
岷	idt
鸶	aae
痣	mhw
闳	pyq
帼	moa
碴	bwi
芍	rre
犊	laq
蝈	qoa
粽	flu
侗	tpi
喟	osu
傥	tbr
卟	onb
蓟	rbv
馊	nxs
堇	roh
踮	fmn
冗	lpr
倜	tph
蹩	ckf
珩	aib
奂	npj
戌	tix
鄢	ird
濡	jyv
谀	exe
镐	cdo
僖	tko
幄	msr
狒	gxv
颛	ivb
鹧	mre
箕	dqj
翦	uuc
摹	skm
愫	nhj
椁	wdb
倌	tlz
佝	tro
萼	rrq
骧	hfv
锹	cvs
娼	xgg
燮	ssz
弭	xsm
诌	enp
泗	jor
鸪	feg
洵	jrg
雉	muz
漕	jjg
怩	nsl
猷	uje
贰	tdq
汶	jzw
淆	jzu
赣	ykq
钊	cvz
轶	fmy
鳍	byg
忸	nen
喙	oeg
筵	dmn
丶	eez
橇	wff
箬	dyo
祚	ztz
燧	sun
沂	jey
繇	blj
蕙	rhw
濠	jdg
沅	jvy
莆	rap
砺	bvu
槟	wle
骛	qkh
刽	epv
獗	gvt
睑	qeb
岈	iik
牒	guw
艮	qpg
荥	rlb
妪	xkz
诠	eea
悖	nab
唳	opj
纾	aqk
浃	jbc
狻	gqk
蚱	qtz
钏	cyc
搡	kzw
浣	jlv
谗	enc
麋	plf
钺	ctl
宕	lbd
鹄	loe
砥	byt
杈	wze
呷	osx
撸	kbg
邈	gxn
膘	upu
橄	wpk
滟	jng
俪	tip
谤	evi
鸩	mle
怆	ned
忾	nvk
邝	mdk
缮	aho
汾	jst
绉	anp
攫	kqz
畸	sjx
磬	hrb
蹇	ljf
钠	chn
贻	qqo
舀	bxy
恁	tcw
箐	dhu
腓	uyf
铝	coo
赳	xnj
沏	jtt
氢	vy
檄	wxk
坂	hvz
炷	sfz
垩	zhe
隽	uhj
驽	xzh
陲	dzj
泾	jyy
蹶	fvt
哺	oab
磺	bjs
匝	kmz
讼	esq
掇	kzz
霰	yuk
哔	ola
坯	hsi
蘸	rpr
嫒	xbz
苓	rge
遛	ytn
皋	xja
僮	tvf
跖	fbz
佞	tdx
衩	zze
鳗	bgz
涿	jge
翳	krc
糠	fmb
彝	efr
荔	rcc
髦	tff
佶	tkj
娣	xcx
胛	usj
铄	cyj
诘	ekj
濮	jze
浒	jel
敕	wok
逅	gon
姹	xlt
迤	mwn
巽	dds
钜	cks
嗑	ohv
舶	ixb
仨	tbs
翕	eoc
豸	gmz
厩	vqi
莓	rme
颀	ebq
锺	czf
阚	pps
舄	xrr
孚	bbf
呶	oxz
呔	oje
蜍	qew
貉	gkh
莜	rtk
藜	rvb
肪	uif
膻	ufi
刎	rav
氅	bkf
聃	sph
泸	jns
阪	dvz
懑	jrw
猡	gdn
圜	odi
儆	trk
逖	gsn
聒	szg
邙	fdm
秣	vym
汕	jis
扪	kpm
谒	egr
衾	gfv
龅	xor
戗	edt
姝	xys
昶	ebg
埔	hap
罄	hrl
蛀	qfz
嗳	obz
绶	abz
汨	jgm
谩	egz
螟	qls
佥	ebq
邂	ntn
竣	vqk
耘	ypy
俾	txb
沱	jll
蜚	yqf
湫	jvs
焊	sgh
砝	bhq
舐	zyt
赝	vtq
恹	nvj
蛭	qrz
滇	jas
剜	lnv
昀	grc
缙	azg
鸵	ell
樽	wuk
俟	tqm
谆	edb
裨	zx
蒺	rmm
涪	jvo
葩	rxg
诃	exh
鞅	zuy
踊	fqb
氐	yte
荏	rtc
淙	jlu
蹴	fie
藓	rbh
煅	syr
谡	esk
猕	gnj
浚	jqk
淞	jsq
瘌	mwv
潸	jwu
跛	fzb
桢	wnq
坨	hll
俦	tyk
楔	wtj
铤	ccn
犟	xol
矍	qqz
菠	yzb
诮	ebu
笆	dgb
崧	iwq
绥	abx
獐	gya
溥	jak
恫	npi
饪	ncr
殄	nef
昴	gyd
槿	wrh
牦	lfm
馍	nsm
砧	bnz
葳	rti
滂	jvi
绡	abu
鎏	jfc
骓	huz
醐	pfu
囱	ckc
噱	opg
黜	zoi
哓	otr
祛	zhq
抨	khc
绺	ano
咩	ohm
醍	pgx
戊	tiw
茁	roi
佃	tsd
蚤	zeq
塾	dwh
谟	esm
釉	mfs
谚	evf
诰	elo
锟	cgl
灞	jyu
町	skd
嗄	obk
逡	qsn
葭	rfz
柩	wkn
滓	jlv
跻	fzv
棂	wps
诳	ega
籽	fbz
囫	ora
锷	crq
碱	bti
奘	ghj
獬	gtl
夯	jch
痿	mvx
痍	mjx
秧	vuy
榷	wlu
忱	nml
鱿	bie
圉	ohu
峪	isn
绌	aoi
馗	wub
酉	piy
莒	roo
嶂	iya
酡	pll
崴	iti
镌	cuh
殁	nrm
膑	ule
徇	irg
纭	apy
脶	uoh
鹘	neg
腌	ujl
叁	qjb
碇	blx
晷	gko
兕	ors
渚	jyz
刍	npc
痘	miu
嚯	oyu
莅	rtv
蛎	qvu
龛	eoz
谔	erq
槊	uuw
豢	hgh
胫	uyy
仝	eyt
佰	tbg
碜	bqf
殡	nle
绦	akw
闩	pis
瘀	mic
哞	oql
蓿	rlg
驷	hor
玖	ane
锲	ctj
耒	yil
鄱	msd
亟	pki
砣	bll
濯	jcu
俎	eeu
糅	fqw
貅	gtw
饯	nit
溧	jpw
犴	gha
诓	eka
訇	reh
嗟	ohy
莘	rvs
偈	tgr
乜	uln
靛	hux
郏	bcd
栾	iwl
葺	ros
锃	coa
螯	pqa
泫	jax
褓	zow
懋	www
锉	cwh
镫	cxu
掾	keg
媾	xjp
桠	wzy
枰	whc
萋	rax
稔	vgw
荻	rgs
琚	asf
侩	tep
蝮	qmk
槁	wdo
遴	fnn
岫	isx
皖	xlv
鹜	qke
皈	xvz
菟	rbt
蓑	rfv
邳	sid
蔺	rpu
襁	zxq
徉	ihy
盥	xbv
幂	lgm
觞	nbh
炅	gsg
貔	gcl
阡	dzq
呖	ovc
蚨	qbf
溉	jqi
懔	nfu
颧	rub
糨	fxq
虱	amq
蜮	qto
舢	iis
铩	czw
鸷	iez
砀	bha
咭	okj
腩	udu
沆	jfp
氮	vss
忝	ijj
抟	kdq
薜	rsv
睢	qus
狴	glh
烩	sep
缃	acx
悌	ncx
蝾	qrw
抻	kgf
猢	gfu
嘞	ozc
爻	zzy
牍	gaq
嶷	imx
蒿	rdo
骅	hla
钹	crb
嵇	vei
孑	bpj
俅	tbe
墒	hdn
愎	nmk
囡	oxn
饽	nab
橐	aow
梏	wlo
轸	fef
纂	dqj
韪	gxd
黢	zqk
羸	fhl
狍	grd
撺	klf
仃	tkd
殚	nca
鬣	tyc
樟	wya
桎	wrz
呙	ohg
璺	xpa
璎	aqx
镏	cts
橹	wbg
祆	zij
酵	pyb
徜	ibp
崂	irc
铀	csy
榔	wed
肓	fuh
镁	chj
芩	rgq
狲	gbj
铡	cqv
祉	zxz
酪	pkl
酗	pzo
擢	kcu
珐	ahq
鼬	xcs
啮	oxo
鹑	dbe
椿	whg
镞	cim
镛	cmu
蜢	qbv
檬	wrg
箔	djx
饨	nto
貊	gbg
馄	ngl
椋	wdj
寮	ljj
逦	ipn
蝌	qvq
骢	hcw
蛔	qoo
辂	fkl
诿	evx
伥	tzc
殓	neb
挝	kkn
诨	elf
爿	gpp
铨	cea
珲	alf
楸	wvs
赊	qeu
窳	lxx
赁	tcq
谌	eql
聩	sqq
煲	tos
钨	cew
茯	rtj
摺	kcx
罹	dnu
硭	brf
掼	keq
蚋	qhr
旮	wgg
铣	clr
絷	iaj
辍	fzz
酊	pkd
蛐	qgv
暨	qii
蜇	keq
镝	cdf
肛	uyg
莠	rvh
砒	blp
邴	ihd
栉	wrd
驺	hnp
柠	wlk
歃	zxt
鳕	byp
怼	zkw
訾	xle
鲧	bmj
雒	kul
酩	pno
黩	zaq
耆	ylg
嘬	ogz
孢	brd
誊	het
斫	bez
媸	xvq
岬	isj
嵬	ixr
泖	jyd
蹉	fhy
蟊	qqq
遒	unq
缛	avk
轱	ffg
旯	gwl
褫	zvp
谯	eur
纛	hjj
僭	tig
妁	xre
孛	alb
诟	ego
闱	pdd
谶	ewt
虺	irq
檑	wys
榈	wpo
跎	fll
牯	lfg
煨	ssv
悒	nog
祧	zcc
瑗	abz
闫	pby
蚺	qph
獾	gru
揆	kxj
诙	eys
嫱	xao
囿	oyu
箸	dyz
啖	oss
痂	mvj
廿	rin
赭	hiy
蔗	rmr
鼹	xcx
篙	ddo
辔	aao
椤	wdn
阒	pqj
埠	hza
伉	tfp
嫫	xsm
钴	cfg
饴	nqo
荚	rbc
裾	zsf
弁	qrb
衢	iqb
阕	pxi
痔	mhk
葆	rtw
蟋	qmw
锴	clx
糸	ajm
喑	oyy
岿	ivp
豕	gis
蚪	qqd
笞	dqo
晗	ggo
蟀	qfa
菀	rld
隍	dxa
逶	vxn
暝	gls
茕	rla
撷	kkb
拮	kkj
獭	gwq
磔	bqw
滦	jiw
嘁	otn
荇	rib
搽	krw
笮	dtz
胪	uns
滁	jdw
泅	joe
湎	jbd
娩	xnr
觥	nbr
饬	nmc
徕	iyc
闰	par
掴	koa
璜	ajs
唁	oey
涝	jrc
汞	ybg
傈	tpw
錾	fec
巯	yyy
鲽	buw
讫	ema
俚	tfl
姘	xcq
猁	gvv
菅	rlz
耦	ysp
荟	rep
谥	euv
绻	ahd
肱	uyq
埙	hoq
铆	cyd
琨	agl
狎	gsx
哙	oep
耄	ylf
珉	adt
挈	ytk
逑	ben
炻	sbs
怄	nkz
鳝	bho
汛	jaa
铂	cxb
跹	fzn
徭	ibl
埂	hiz
颢	gjb
猞	gef
铖	ctu
蓐	rvk
楹	whv
貘	gsm
凼	bod
赅	qyg
稹	vas
镗	cbh
癣	mbh
铢	cyz
裱	zhv
倥	tly
涞	jyc
阆	peq
傩	tzu
钎	czq
蜉	qbb
悱	nyf
仄	vez
粕	fxp
纥	ama
焘	ykr
珙	ajs
栎	wyj
胰	ujx
脔	ihe
缳	adv
觜	xlb
锝	cgk
蕤	rgm
唿	orw
柚	wsy
荜	rla
鲫	bqd
洌	jnv
螈	qvj
秆	vhg
骞	ljh
蕲	rae
仵	tlw
苻	rtk
斛	nbq
搴	ljk
瘙	mzq
獍	gyr
郗	zyd
醴	pgu
铬	ckg
篁	dxa
杷	wgp
烊	shy
郜	lod
纩	amk
脍	uep
鹂	ipe
牝	llp
骈	hcq
莳	rgk
熨	sks
钿	csd
冼	clr
柑	wri
孀	xyc
恚	awh
氦	vyh
湟	jxa
锒	ceq
锌	cvx
鹬	qpe
戕	gtq
缦	agz
虻	qfm
篾	ddt
衽	zcr
帏	mdd
轾	frz
碣	bgr
膂	imu
堞	huw
暾	gdk
鼐	hgg
炝	sed
窨	lyy
鲟	bpk
偬	trw
硌	bkg
恽	nlf
咴	oys
竦	vwo
邰	qod
虢	bkp
覃	pga
韭	yij
蕨	rvt
铉	cax
泵	bbb
帧	mnq
胱	ubr
缟	ado
屐	siz
苌	rzc
腱	upn
侔	tql
鳃	bsw
讦	ehj
圻	heq
椽	weg
癯	mqu
灏	jgb
洮	jcc
拊	ktk
眙	qqo
尜	jjj
骝	hts
髭	txl
蝰	qja
痨	mrc
竽	dhy
狯	gep
剡	ssv
鼋	vol
腚	ulx
猱	gqw
辚	ffq
螫	hkq
缢	auv
酶	pme
嘌	opu
椴	wyr
洹	jii
趺	fbf
盱	qhx
犍	lpn
镊	csz
噻	olh
庹	mrg
钙	ciq
赡	qne
罅	lpa
珥	ase
狃	gen
镙	csj
撄	kqx
圩	hhx
杌	wir
峄	izh
箴	dti
炔	suq
茔	rlh
墉	hmu
鏊	pca
焙	svo
馏	nts
畲	eus
欹	jxt
洇	joj
吡	olb
仟	tzq
馐	nhe
宥	lyu
鼍	rsl
苫	rns
囹	oge
荛	rtr
氯	vpb
昃	gve
缱	aqn
峤	imv
龈	xoq
睇	qcx
娈	ixl
蹼	fze
榛	whv
蟥	qjs
臬	bwn
殳	rms
擀	keh
旄	ifm
犰	gwq
彀	hxr
狁	gqr
诤	enk
傣	thb
裢	zfn
搠	kuu
樨	wsl
鹌	jle
踟	fmo
铰	cfw
焖	spw
痢	mvv
锰	cbv
厣	vjs
瘐	mxe
蠹	aqq
楫	wos
澧	jgu
郓	lfd
秸	vkj
砦	xlb
璁	acw
柞	wtz
纫	ate
纡	ahy
腭	urq
骐	hqq
黟	znn
瘿	mqx
捭	kxb
芨	rhj
笳	dvj
嵯	ihy
颏	ybk
郧	oqd
妣	xlb
钾	csj
酃	yrd
圄	ojo
稞	vgw
苡	rgy
杼	wqk
戡	qlt
勐	bvc
薨	rnl
蛉	qge
澍	jkk
雩	ydq
骘	dxh
憷	nwx
茴	roo
诜	elr
淖	jna
筅	dlr
佚	tmy
襦	zyv
郇	rgd
吖	ocf
檫	wlu
帔	mzp
垭	hzy
凫	epf
鹗	rqe
钯	cgb
邗	hdh
舛	nqc
謇	lje
荠	rzv
佤	thw
矽	bnx
喁	osp
粑	fgb
垓	hyg
苕	rto
浔	jpk
芫	rvy
煸	spv
蝓	qeu
迓	ikn
杓	wre
躅	fdr
褡	zro
矾	bpe
喈	olx
沔	jiu
樘	wbh
锨	cet
蜊	qvv
搦	kxx
鲵	bxr
烷	slv
蕈	rpa
刭	yyv
丨	ffs
幛	mya
踯	fcd
堠	hsm
闼	pjn
愀	nvs
鄯	hod
缁	ays
氰	vhu
瓤	fvx
肜	ufr
摈	kle
氟	vxv
厶	qps
瀣	jzi
鲰	bsz
怫	nxv
坩	hri
陉	dyy
疟	mpy
褰	ljv
渑	jol
笫	dqm
裣	zeb
菸	ric
痼	mof
阄	png
缗	adg
媪	xgv
疱	mrd
悭	nzh
尻	swk
罴	dhr
燹	ggs
疥	mev
衿	zgj
艏	iub
亳	dmt
邛	ydq
眭	qas
旒	ify
茏	rzl
樯	wao
艄	ibu
孳	uab
鲶	bgw
卅	vis
黍	veb
鲑	bag
氖	vhn
怛	ngi
枋	wif
蒹	rui
菘	rwq
豌	iud
泶	bbx
笏	dra
忉	ntd
淝	jug
榉	wbh
踽	fmp
廪	mfu
裎	zoa
桁	wib
萑	ruh
濂	jmi
鲈	bns
疹	mef
逋	anb
栳	wyl
蚍	qlp
苒	rph
蝣	qib
铙	ctr
殍	nbb
陂	dzb
埚	hoh
麂	plp
妊	xcr
唢	obq
锗	cyz
擘	svk
趸	buf
赍	awq
谰	epw
歙	ect
縻	mwj
焯	sna
矬	mwh
烯	szm
荩	rgc
艨	irg
眇	qjm
瓴	geh
亍	bic
佧	tne
叻	ocl
箝	dkr
勰	ccw
氨	vlx
喱	ovf
飨	amn
翥	ycz
侪	tzv
桫	wjj
鲠	biz
茑	ren
蚝	qfh
跗	ftk
焓	sgo
洄	joo
疽	muj
笤	dto
篦	dcl
鹕	fue
雎	uuj
胺	ulx
蹰	fvk
阋	pxr
钬	csh
镪	cxq
馕	nav
艟	ivf
毂	hfr
鹈	cme
庠	mhx
猗	gjx
瞽	kaq
疴	mxk
踅	kef
棼	wst
睾	mda
鹳	rue
疡	mha
锍	cfy
漭	jrr
跸	fla
醮	pur
砬	bvl
濉	jqu
柢	wyt
泷	jzl
逄	kqn
埘	hgk
陟	dxj
耋	ylr
笄	dqj
蚧	qev
蝥	qkq
塄	hdi
萘	rju
郯	ssd
烃	syy
酮	ppi
彖	egt
痫	mpw
鼙	kax
掮	kpu
趿	fht
帑	xzm
馔	nds
鲇	bnn
畦	saq
蚜	qik
枸	wro
狷	gou
尢	iiy
稗	vxb
窠	lgw
溘	jhv
矸	bhg
岢	ixk
沭	jwe
钲	cix
蠃	fql
睃	qqk
庾	mxe
扦	kzq
鸱	yte
哚	opw
菔	ruz
枥	wvc
轳	fns
蟛	qkf
觋	ywl
祜	zfh
蚰	qsy
狳	gew
倬	tna
锱	cys
蛄	qfg
醪	pcf
囟	czx
爰	bhz
奁	jkz
擤	kbr
槎	why
鞒	zmv
嬗	xfi
嗉	ohj
鳐	bbl
柘	wbz
毖	lwm
舸	ixg
镍	cbw
鋈	jmc
潆	jrj
侑	tyu
谘	eto
耔	ybz
锕	cdx
豳	igg
芾	rim
乩	nlj
渌	jpb
禳	zfv
綦	qaj
锑	ccx
钤	cgq
砭	bma
鳏	bdc
辊	fgl
娠	xvv
鬻	xxp
洙	jyz
墀	hsl
孥	xzb
疣	mie
茇	rrb
耪	yvi
芪	ryt
愆	ibw
筮	dyw
榫	wua
栀	wgd
薅	rxk
萁	rqq
蜞	qqq
蛩	ypq
罨	djl
鳟	buk
阍	pyt
龃	xou
莰	rht
酽	pzm
栲	wyq
氪	vfr
饣	nms
崤	izu
啁	oph
铋	cwm
碘	bps
觚	nbx
毽	fph
捌	kuv
樾	wxt
瘢	mir
茌	rth
鹚	uae
骶	nyt
菏	yxh
糁	fqf
穑	vao
溏	jmo
刖	uvy
嫜	xya
螽	kqq
缒	azn
滹	jpa
髋	nll
攮	kav
楂	wwi
戽	pqh
铧	cla
囝	obn
愍	dkw
坭	hsl
熵	sdn
澶	jfi
鲂	bif
鞯	zrb
橛	wvt
飧	nns
痈	mby
枞	wwz
殂	nuc
冱	cie
匏	jqr
蠼	qqz
嵊	ivc
艉	isf
岙	mji
樗	wyq
遄	ibn
舂	hxc
椟	waq
尕	hjg
柙	wsx
伧	ted
坻	hyt
瓠	jqx
镬	crz
髡	tfr
薮	rxk
蔌	rwt
龉	xoo
鹾	noy
讣	enf
皲	lfz
髁	ngw
杲	gwg
芰	raz
椐	wsf
橼	weg
缯	acg
鸹	zeg
龋	xop
莪	rkt
锞	cgw
圹	hmk
黧	vrz
隈	dsv
彘	eml
暌	gxj
餍	vjn
赜	khq
筚	dla
泔	jri
嘏	fsz
疠	mbu
鸬	nse
檠	rkw
饧	nha
醯	pfv
蚬	qlx
蓖	rcl
哏	oqg
蹁	fpv
朐	uro
疋	pxs
甑	cgh
绂	arf
铗	cbc
髫	tfo
螅	qbw
宄	lwg
芎	rxx
摭	kmr
膣	ulr
苷	rri
骟	hpc
圯	hdy
棹	wna
枳	wos
啭	odq
蔟	rim
妫	xcc
鍪	qkc
夤	nli
牖	gpa
觯	nba
棰	wzj
盍	hqv
茭	rfw
耨	yvk
鞣	zqw
钡	cqb
礅	bdk
苴	ruj
熘	sts
硼	buu
秫	vwe
铊	cll
柁	wll
壅	fah
飑	prd
膈	uip
钪	cfp
箜	dly
缡	azp
醚	pfn
敉	fkm
甯	lwb
潍	jau
寤	lgo
肄	lmh
阈	pto
跏	fvj
栊	wzl
栌	wns
涑	jwo
脘	ulv
酎	pkz
柒	jtw
谵	ene
鲳	bgg
茈	rxl
痱	myf
鬈	tfd
蛳	qim
秭	vmq
阏	pie
捩	kpj
镆	csm
枇	wlp
枵	woq
氚	vyc
皴	qkz
堀	hsi
讴	ekz
圊	ohu
穰	vfv
蟮	qho
忄	nex
笥	duo
焐	sjo
菖	rgg
绐	aqo
儋	tne
邡	idf
蓼	rcf
蒌	rfx
圮	hdp
浠	jzm
廨	mnl
怙	nfh
闶	pfp
瓿	voh
诂	efg
粳	fiz
鳓	bzc
漯	jsj
眚	mhq
庑	mhl
苎	rli
觳	hbr
楗	wpn
徼	ixk
莨	req
黥	zdj
芴	rra
酰	plr
柽	wzh
钭	cqt
揿	kct
蓊	rsc
馑	nrh
喾	blo
僳	tpf
揎	kli
挹	kog
芏	rhd
剀	idv
愦	nqq
曩	gfv
袢	zyp
酾	pip
硒	bpx
曛	gzz
俣	toj
笊	dxz
卮	gdz
汊	jze
郴	wdc
雠	ueu
鲷	bph
仂	tcl
莴	roh
癍	maa
榧	wky
鹣	uie
蘖	rzw
旆	iim
蕖	ykw
桡	wtr
荪	rbj
婺	qkx
妯	xsz
钣	cvz
亻	tmr
垆	hns
沤	jkz
屣	six
卺	pbd
嫠	yvx
蘼	rmy
坶	hem
蘧	rpn
镒	cuv
蕞	rsz
玢	ast
厝	vjg
锆	clo
鬲	iop
詈	del
箧	dkb
铴	cjh
怃	nhl
浜	jes
鳔	bpu
缶	lmf
藿	ryu
蛑	qql
柰	wun
鼗	cuz
蓥	rlc
欤	dty
钚	csb
丌	rij
蛞	qzk
娌	xfl
鲆	bhc
癔	myw
鄣	yad
酢	ptc
骖	hqf
酲	poa
碓	bud
妗	xgj
麈	plf
傧	tle
燔	sms
黻	zmr
缂	azk
鹩	jje
碛	bhq
铱	cfv
塬	hvj
韫	ddv
揸	kwi
趵	fre
屙	sdx
猓	ggw
檩	wfu
谝	epv
笸	dko
蜣	qhl
溽	jvk
蜩	qph
乇	mtt
囗	ofw
痦	mjo
赀	xlq
萏	rnx
偾	taq
鄄	phd
岘	ilx
揠	kkg
伛	tkz
碚	bvo
阊	pgg
蕺	rst
孓	pke
镧	cpw
锊	cbk
铍	czp
溱	jhv
昝	kng
胙	utz
瑷	abz
邶	cld
坫	hnd
伲	tsl
芑	rdq
缬	akb
硎	bqv
镟	cix
糌	fng
隹	umc
坼	hee
幞	mze
戢	ost
崃	iyc
髀	nxb
忭	nfn
箪	dca
瞢	rdq
筌	dea
菽	rjz
荨	rpk
郅	rdz
锛	cjr
笾	dcn
篪	dvp
辏	fhj
癜	msr
钒	cpe
哕	oin
敫	xik
廑	mrh
鲢	bfn
仳	tlp
厍	vfs
砷	bgf
蓍	ryg
鳎	bgc
圬	hdq
欷	zyt
碹	bli
甏	kfh
檗	svw
豉	iuz
淦	jcg
磙	bfv
苣	rks
艿	rhn
颞	szb
嗍	ouu
胝	uyt
槠	wey
诼	ege
诹	esz
麸	hkb
蛱	qbc
鞫	zre
锂	cfl
荞	rmv
轫	fte
椹	wql
郾	kgd
楱	whj
迨	qon
氘	vvd
槲	wnq
耩	yjp
熳	sgz
缌	asw
恂	nrg
铟	coj
卣	nos
唣	oxt
苁	rwc
裉	zqk
瘰	msj
泺	jyj
锘	cro
璩	apg
薹	rkh
阌	pbz
堙	hph
茺	rfr
砩	bxv
蓠	rzp
啉	owl
黾	ogl
诒	eqo
唑	owh
砗	bfc
羝	hyt
顸	hbh
刳	jqv
杩	whm
俳	typ
慊	nui
缫	ayw
茼	rpi
狺	gey
缍	azj
圪	hma
麇	plv
悝	nfk
尥	ire
狨	gty
铯	cng
嗾	oim
胗	uef
痤	mwh
隳	dyj
镢	cvt
鹋	rse
槭	wtn
畹	sld
嵛	ieu
饫	nmj
蘩	rmj
赓	mpq
绲	agl
翮	ipc
郐	epd
缧	asj
酹	pbk
唛	ohk
颟	rfb
蠓	qrg
眄	qiu
葚	rql
腧	ueu
溲	jxs
溻	jgc
踬	fvq
怍	ntz
畚	qjs
嬖	svx
糍	fua
旰	ghg
鞲	zjp
涫	jlz
颃	fpb
荭	ray
嵴	icu
垲	hid
呒	ohl
胼	ucq
芡	rtq
朊	uvr
馓	njk
跣	flr
刈	zvy
萸	rxe
龠	erv
帻	mhq
瘳	mcf
疸	mgi
磴	bxu
陔	dyg
醢	pyv
踺	fpn
蠲	uvr
蛸	qbu
硖	bbc
鲞	hbx
蚴	qac
镲	clu
戥	ght
葑	rak
篌	dtm
栝	wzg
耧	yfx
峁	iyd
堋	huu
芘	rlp
謦	hre
鸲	roe
颡	zwb
鄞	rhd
嗌	ouv
踔	fna
疔	mkd
铒	cse
犭	gmq
桄	wbr
屦	six
侉	tjq
粝	fvu
瘘	mfx
痧	mjj
绨	acx
葸	rsw
薏	ryw
仉	tpz
廛	mfh
簟	dpa
裰	zzz
畈	svz
鲋	btk
舻	ins
皤	xms
嗪	ohv
凇	csq
谇	efa
掭	kij
燠	scj
虿	buq
莼	rat
毳	fff
簦	dxu
蹀	fuw
胍	uxg
缣	aui
枧	wlj
鲮	bhk
陧	dgh
泮	jyp
梃	wcn
醑	ppu
勖	gqc
谖	ebz
谳	eje
铘	cid
轭	fvd
酐	phg
庋	maz
僬	tur
贶	qor
醅	pvo
蝤	quq
垧	hco
锬	css
趑	xct
菹	yuz
龀	xol
藁	rdw
诖	eag
匦	kfw
笕	dlj
硷	beb
锩	chd
垅	hzl
肭	uhn
陴	dxp
吣	owq
醛	pra
蒴	rvu
邾	ydz
鳊	bpv
鸸	bve
桴	wbb
搿	kek
胲	uyh
剞	jxv
鬏	tvs
芤	rbl
嵝	ifx
艋	ibv
悛	nqk
疝	mis
柝	wee
鲔	byu
拶	kyn
黹	zcm
舯	ikz
箅	dsr
榇	wvw
菰	rbx
煳	sfu
劂	vcv
蚵	qxh
礞	brg
钼	cqm
嬲	scc
劬	roc
肽	uje
洧	jyu
硪	bkt
葙	rcx
埸	hgr
廴	npy
躜	flq
鬯	zol
匚	kif
鲱	byf
砜	bpf
呋	obf
莩	rbb
鹨	cfe
墁	hgz
觫	nbw
辋	fpu
隰	dgr
獯	gzz
佾	tsu
媵	uhx
趱	xll
髌	nle
埕	hoa
谠	ebr
碲	bvm
垤	hrd
唪	ohh
绀	ari
铪	ceo
洚	jkq
嫘	xsj
楝	wwd
甍	rdh
髂	nlk
磲	bkw
绱	abp
潲	jbu
鲥	bgk
铵	clx
舨	ivz
羼	shh
笪	dgi
酚	pst
刿	inv
曷	grl
溷	jog
骱	nev
胬	xzh
俜	tsq
銎	ypc
诎	eoi
枘	whr
镡	cpa
粜	oif
浯	jjo
绁	aux
崦	ijl
劓	brv
蓣	rkb
菝	rkr
鐾	svc
蛏	qzh
汆	meb
甙	tri
蒽	row
绋	axv
岣	iro
崮	iof
岵	ifh
掎	kjx
挢	kmv
讵	eks
窭	lfx
赉	ycq
掊	kvo
芟	rrs
毹	euf
锶	csw
慝	krw
氽	ebt
芄	rwe
怿	nzh
鹆	sne
瘵	mxu
啶	olx
蔸	rxr
砘	bto
罟	dfg
蚶	qri
鲎	bbh
锾	cbz
湔	juu
搛	kui
柃	wge
逯	pbn
亓	dvq
屺	idq
郄	zyd
檎	wep
毵	qff
渖	jlf
肟	udq
饩	nvx
躞	fsz
谮	eig
酯	plg
塍	uhh
擐	kdv
蠖	qrz
觖	nbu
跬	fak
氇	fbg
嘧	oli
蝻	qdu
湓	jsv
氆	fuz
庥	mtw
嵫	iua
撙	kuk
褊	zpv
篼	dxr
鳜	bvt
劢	buc
蛴	qzv
汔	jma
骀	hqo
醣	pmo
腽	ugv
舾	ipx
仡	tma
莸	rgi
黼	zma
袼	zkg
缑	asm
笱	dro
袷	zeo
肼	urj
僦	tie
蒉	rqq
阃	pow
臁	umi
倮	tgw
芈	fih
杪	wjm
蠛	qrt
蛲	qtr
凵	opk
硗	btr
跫	ypf
荽	rbx
渫	juw
崾	ipx
瘗	mbh
箦	dhq
舳	isz
阝	dpf
黪	zqf
锸	czx
瓞	xmd
滏	jwu
戆	ykw
遘	jpn
簋	dqv
鹪	ure
扃	ppo
篥	dpw
鞔	znr
浼	jnr
庀	mlp
肷	utq
鲭	bhu
埽	hpm
钽	cgi
酴	pew
溆	jez
钸	cym
髑	ndr
鳆	bmk
黉	bjs
逭	lzn
浍	jep
裥	zpg
榘	mkw
犋	lus
钌	cpk
躐	fyc
砻	zbl
苤	rsi
榀	wor
钋	cnp
綮	pkj
氵	jes
胂	ugf
锼	cxs
炱	qos
疃	svf
煺	sqn
鼯	xco
籼	fix
芗	ram
儇	tdv
砟	btz
肫	uto
秕	vlb
踣	fvo
刂	vfd
帱	myk
氡	vkc
垌	hpi
佴	tse
糇	fsm
肀	pfy
澌	jqe
耜	yzs
龆	xoo
禊	ztj
溴	jbj
氩	vzy
吲	oxf
岜	igb
惝	nbp
蝽	qhg
腠	uhj
徂	iuc
硐	bpi
镉	cip
虼	qma
烀	sma
蟪	qhw
桷	wnb
坜	hvc
瞵	qfq
簏	dpl
镘	cgz
擗	ksv
筇	dyd
扌	kis
畋	skt
葶	rdk
沲	jmw
穸	lnx
眢	ndq
搌	ksv
埴	hau
陬	dsz
砹	brz
畀	srb
鹁	abe
觇	nlc
彳	imc
瘅	mca
菪	rlb
铞	com
锇	ckt
钫	cif
廾	rig
砉	ybh
锪	crw
哜	ozv
钅	cmj
锔	csu
膦	ufq
螨	qrf
茆	ryd
埤	hxb
铈	cfm
裼	zgr
迕	lnw
氙	vix
楦	wli
讠	eey
蛘	qhy
镱	cyw
霪	yjc
畛	sef
碡	bhe
缵	alq
锿	cdv
襞	svv
髟	tfb
蒇	rtq
冁	cav
籴	mef
揲	kuw
镦	cdk
苊	rvd
疳	mri
茛	rqg
鳇	bxa
攉	kyu
虮	qpj
镓	clg
噍	our
弪	xyy
胩	une
罱	ddu
苈	rvc
蠊	qmi
埝	hgw
钕	cxn
羟	hyy
羰	his
轺	fto
舴	itz
潴	jgy
萆	rxb
晡	gab
爨	xps
榱	wfv
铥	czq
鸫	fje
胨	ufj
罘	dsf
槔	wxa
鹱	erz
墼	frh
骒	hgw
悃	now
漤	jwx
稂	veq
诔	eyl
鲡	bip
疬	mvc
钔	cpm
淠	jsr
裒	fxv
缲	aow
薷	ryv
埏	hmn
谂	egw
鲦	bkw
莛	rcn
榍	wsu
髹	ttw
砑	bik
垸	hlv
帙	mmz
窀	lto
浞	jfz
辶	nec
褙	zlu
苄	rfn
骣	hsb
舡	iyc
岽	ifj
攵	kmp
赙	qak
漶	jow
跽	fdw
疖	mdj
腈	uhu
桕	wxj
桊	hwj
埒	hbk
镅	csq
镎	cek
哌	ovv
郫	xdp
冖	lem
锖	chu
畎	sje
悫	hlw
颥	yvb
唼	ovx
钐	cfs
矧	mxf
牾	ljo
鹇	pwe
殪	nhu
鳙	bmu
饔	fan
籀	dks
鄹	sbd
宀	lem
坌	sth
荸	rab
艚	ijg
艹	ria
觌	aql
铫	ccc
鲼	baq
澉	jpk
哿	vxg
瘊	mtm
骺	ngo
豇	iuy
筘	dko
硇	bcz
聍	slk
蜱	qxp
丿	mmp
氍	quf
酞	pje
钍	cht
沩	jcc
洫	jmv
珧	acc
舁	xry
瀹	jev
粢	ctf
鲅	brb
鞴	zjb
窆	lma
瘛	myw
镄	cxq
祓	zrf
恝	ytw
瘕	msz
戋	itj
鲒	bkj
醵	ppg
瘼	msm
铌	csl
脬	ubb
葜	ryj
椠	few
瞍	qxs
羧	hqk
冂	pfj
粞	fpx
蓰	rix
窬	leu
哳	oke
轵	fos
忮	naz
埯	hjl
聱	psa
礤	bru
搋	kvp
憝	dkw
钆	clg
艽	rwj
鳘	mkb
恧	bvw
襻	zwk
氕	vmp
镨	cug
铷	cxo
洳	jxo
蟓	qbx
鸺	twe
铕	cyu
驵	huz
迮	tnz
廒	mpa
濞	jbr
巛	ypc
嶝	ixu
耵	skd
蹯	fms
篚	dky
嚆	ord
劐	rzv
鲚	bzv
鲣	bzh
趼	fqj
赆	qgc
爝	sbk
钶	cxk
鳢	bgu
荬	rpq
镤	cze
桤	wid
筲	dbu
堍	hbt
箨	dkh
蕹	rmu
钇	cay
罾	dcg
夂	kmz
橥	gyw
鲻	bys
阼	dtz
揞	kya
庳	mxb
馇	nwi
怊	nto
脞	uwh
埭	hpb
塥	hip
绠	aiz
蕻	rqs
鲩	blv
癀	mjs
洎	jbj
礓	bii
捃	kpo
锎	cpq
轹	fyj
跞	fyj
瞀	qkq
猸	gsq
鹛	sqe
脒	ufm
耱	ymb
衄	mve
甓	svh
锓	cpz
脎	uzw
滠	jsz
鲐	bqo
萜	rmn
砼	bey
涠	jod
衤	zey
甾	ysz
痄	mtz
浈	jnq
瘃	mge
舭	ilb
螬	qjg
躔	fmh
枨	wzc
眵	qnn
镩	clf
卩	dpj
垡	tth
稃	vbb
郛	bbd
酤	pfg
崞	idb
蜾	qgw
捍	kgh
谫	eut
纟	aps
眍	qkz
癃	mdh
毪	fql
仫	tmq
垴	hzo
筢	dkg
锫	cvo
螵	qpu
岍	iqq
亠	fet
阢	dir
菥	rwe
鼷	xcj
薤	rni
舣	iez
著	ryz
丬	uep
腙	ulu
蒡	rvi
勹	rmb
鹎	xeb
滗	jdf
缏	atz
醭	pze
猹	gwi
瘥	mhy
膪	uvo
阽	dnd
簖	dle
牿	llo
馘	ubt
撖	kpk
虍	pfh
缋	aqq
牮	dlj
铼	cyc
铹	crc
泐	jdc
墚	htw
镥	cbg
苠	rdt
脲	usb
蒎	yvv
犏	lpv
钷	cko
劁	urv
鼽	brw
磉	bzw
鲺	bam
礻	zes
贳	uqs
摅	kpw
耥	ybp
螗	qmo
箢	dnd
軎	fow
莶	reb
痃	max
痖	mzy
疰	mfz
碥	bpv
瘭	mpu
傺	txu
鼢	xct
瀵	jfs
艴	xvg
戤	hvt
筻	diz
觏	jpl
鲴	bof
轷	fma
耠	yeo
灬	reh
茳	yyj
喹	oja
醌	pgl
蒗	yeq
铑	cyl
耢	yrc
蔹	rbk
稆	voo
攴	nzp
苘	rpo
赇	qbe
辁	fea
彡	fms
赕	qss
铽	ctw
猃	geb
糈	fpu
酏	pwy
茚	ryd
齄	bri
绗	aib
荮	rak
夼	jyk
螋	qxs
耖	yjc
蒈	rlx
鲕	bbv
禚	zhr
鳋	bzq
冫	ceb
屮	vpc
彐	ppj
疒	men
啰	odn
瞭	qjj
珅	agf
